subjID,run,trial,phase,oriRef,oriJitt,oriFinal,oriRespInit,oriRespFinal,error,points,rt,outoftime,iti,oriRef2,oriFinal2,oriRespFinal2,oriFinal3,oriRespFinal3
1,1,2,3,1,-9,171,85,165,6,88,3.04716232200002,,0.2,0,-9,-15,-9,-15
1,1,3,4,2,-1,44,58,53,-9,82,2.50065732900003,,0.2,45,44,53,-1,8
1,1,4,1,3,6,96,12,99,-3,94,3.69720838500001,,0.2,90,96,99,6,9
1,1,5,3,4,3,138,43,143,-5,90,3.66564499999998,,0.2,135,138,143,3,8
1,1,6,7,1,-9,171,152,164,7,86,1.54777686599999,,0.2,0,-9,-16,-9,-16
1,1,7,2,3,2,92,158,96,-4,92,3.40113881799999,,0.2,90,92,96,2,6
1,1,8,9,1,7,7,25,20,-13,74,3.232186297,,0.2,0,7,20,7,20
1,1,9,1,2,8,53,112,57,-4,92,3.64820191199999,,0.2,45,53,57,8,12
1,1,10,5,4,7,142,70,127,15,70,3.84838154900001,,0.2,135,142,127,7,-8
1,1,11,9,2,7,52,80,69,-17,66,1.73226060999997,,0.2,45,52,69,7,24
1,1,12,2,2,-6,39,112,36,3,94,3.74505999900003,,0.2,45,39,36,-6,-9
1,1,13,10,2,9,54,76,65,-11,78,2.12915625700003,,0.2,45,54,65,9,20
1,1,14,9,1,10,10,69,10,0,100,3.88145908899997,,0.2,0,10,10,10,10
1,1,15,5,4,4,139,115,133,6,88,2.18131430800003,,0.2,135,139,133,4,-2
1,1,16,5,1,7,7,178,8,-1,98,2.03108444400004,,0.2,0,7,8,7,8
1,1,17,3,2,9,54,3,56,-2,96,2.78140651000001,,0.2,45,54,56,9,11
1,1,18,7,4,-4,131,128,128,3,94,0.930809795000016,,0.2,135,131,128,-4,-7
1,1,19,4,3,-3,87,27,85,2,96,2.79808314400003,,0.2,90,87,85,-3,-5
1,1,20,4,2,7,52,24,55,-3,94,3.8810231870001,,0.2,45,52,55,7,10
1,1,21,9,3,-5,85,16,80,5,90,4.16367373199989,,0.2,90,85,80,-5,-10
1,1,22,8,2,8,53,55,55,-2,96,1.01809343299999,,0.2,45,53,55,8,10
1,1,23,5,3,-9,81,80,82,-1,98,2.16465318400003,,0.2,90,81,82,-9,-8
1,1,24,1,1,9,9,166,10,-1,98,2.28223505100004,,0.2,0,9,10,9,10
1,1,25,1,4,-7,128,25,122,6,88,2.83131071000003,,0.2,135,128,122,-7,-13
1,1,26,7,4,-3,132,48,127,5,90,3.03888190399994,,0.2,135,132,127,-3,-8
1,1,27,4,3,3,93,18,102,-9,82,3.06528456500007,,0.2,90,93,102,3,12
1,1,28,10,1,-4,176,134,169,7,86,3.23288330000003,,0.2,0,-4,-11,-4,-11
1,1,29,6,1,5,5,20,6,-1,98,2.46514964300002,,0.2,0,5,6,5,6
1,1,30,4,1,4,4,126,8,-4,92,3.16479917599997,,0.2,0,4,8,4,8
1,1,31,7,2,-2,43,117,36,7,86,3.64213689799999,,0.2,45,43,36,-2,-9
1,1,32,7,2,1,46,61,43,3,94,1.99658331500007,,0.2,45,46,43,1,-2
1,1,33,3,4,-8,127,9,137,-10,80,2.84642396200002,,0.2,135,127,137,-8,2
1,1,34,10,3,9,99,76,102,-3,94,2.59824326599994,,0.2,90,99,102,9,12
1,1,35,6,1,10,10,105,18,-8,84,2.96462378900003,,0.2,0,10,18,10,18
1,1,36,1,4,-8,127,72,122,5,90,2.68039351699997,,0.2,135,127,122,-8,-13
1,1,37,7,3,5,95,42,102,-7,86,2.2657094299999,,0.2,90,95,102,5,12
1,1,38,2,4,1,136,44,138,-2,96,3.09697349999999,,0.2,135,136,138,1,3
1,1,39,8,2,-6,39,161,28,11,78,2.98136687700003,,0.2,45,39,28,-6,-17
1,1,40,5,3,0,90,134,92,-2,96,3.70315084900005,,0.2,90,90,92,0,2
1,1,41,5,3,-5,85,139,83,2,96,3.65022426300004,,0.2,90,85,83,-5,-7
1,1,42,8,3,-1,89,80,87,2,96,3.89893152000002,,0.2,90,89,87,-1,-3
1,1,43,9,4,7,142,83,139,3,94,2.71423626399996,,0.2,135,142,139,7,4
1,1,44,8,4,-10,125,118,120,5,90,2.17987833799998,,0.2,135,125,120,-10,-15
1,1,45,5,3,5,95,53,102,-7,86,2.73753095300003,,0.2,90,95,102,5,12
1,1,46,10,4,2,137,13,141,-4,92,3.04758331099993,,0.2,135,137,141,2,6
1,1,47,2,1,9,9,85,14,-5,90,3.38476652999998,,0.2,0,9,14,9,14
1,1,48,7,1,-9,171,162,161,10,80,1.94916441700002,,0.2,0,-9,-19,-9,-19
1,1,49,4,3,-6,84,25,87,-3,94,3.22771808899995,,0.2,90,84,87,-6,-3
1,1,50,1,2,6,51,115,58,-7,86,2.39766791599993,,0.2,45,51,58,6,13
1,1,51,2,2,-2,43,16,39,4,92,2.14785463999999,,0.2,45,43,39,-2,-6
1,1,52,6,4,-7,128,128,128,0,100,0.965143754999986,,0.2,135,128,128,-7,-7
1,1,53,9,3,-8,82,122,81,1,98,3.46756190400004,,0.2,90,82,81,-8,-9
1,1,54,3,1,-2,178,137,177,1,98,2.18297066000002,,0.2,0,-2,-3,-2,-3
1,1,55,2,4,3,138,123,142,-4,92,1.91397979299995,,0.2,135,138,142,3,7
1,1,56,8,3,-8,82,43,74,8,84,3.27984188799996,,0.2,90,82,74,-8,-16
1,1,57,10,3,-7,83,82,82,1,98,0.731622602000016,,0.2,90,83,82,-7,-8
1,1,58,6,1,0,0,95,0,0,100,3.68047544000001,,0.2,0,0,0,0,0
1,1,59,3,3,-3,87,56,87,0,100,2.78044812400003,,0.2,90,87,87,-3,-3
1,1,60,6,1,5,5,54,7,-2,96,1.93472653299989,,0.2,0,5,7,5,7
1,1,61,2,4,5,140,83,141,-1,98,3.13232928700006,,0.2,135,140,141,5,6
1,1,62,10,2,8,53,77,71,-18,64,1.16526926400002,,0.2,45,53,71,8,26
1,1,63,8,1,-5,175,80,170,5,90,2.98039371899995,,0.2,0,-5,-10,-5,-10
1,1,64,7,1,-2,178,18,166,12,76,2.64987250199999,,0.2,0,-2,-14,-2,-14
1,1,65,5,2,2,47,65,54,-7,86,1.76430290500002,,0.2,45,47,54,2,9
1,1,66,4,3,-1,89,152,85,4,92,3.40092047400003,,0.2,90,89,85,-1,-5
1,1,67,2,3,8,98,126,99,-1,98,2.29957330399998,,0.2,90,98,99,8,9
1,1,68,8,4,6,141,44,140,1,98,2.99857337600008,,0.2,135,141,140,6,5
1,1,69,5,2,7,52,80,51,1,98,1.926971073,,0.2,45,52,51,7,6
1,1,70,6,4,-10,125,100,120,5,90,1.763164598,,0.2,135,125,120,-10,-15
1,1,71,4,2,4,49,25,48,1,98,1.74835412300001,,0.2,45,49,48,4,3
1,1,72,10,4,1,136,9,134,2,96,2.08003857400001,,0.2,135,136,134,1,-1
1,1,73,4,4,-6,129,151,135,-6,88,1.29891782499999,,0.2,135,129,135,-6,0
1,1,74,5,4,-9,126,80,117,9,82,2.46524714400005,,0.2,135,126,117,-9,-18
1,1,75,5,1,-9,171,146,171,0,100,1.94390133000002,,0.2,0,-9,-9,-9,-9
1,1,76,10,2,-4,41,137,30,11,78,2.76379671099994,,0.2,45,41,30,-4,-15
1,1,77,10,1,-4,176,107,173,3,94,2.34803958800001,,0.2,0,-4,-7,-4,-7
1,1,78,3,2,-7,38,53,42,-4,92,1.33608274899996,,0.2,45,38,42,-7,-3
1,1,79,5,2,-5,40,125,31,9,82,2.76746136400004,,0.2,45,40,31,-5,-14
1,1,80,1,3,-7,83,15,79,4,92,2.56498916500004,,0.2,90,83,79,-7,-11
1,1,81,2,1,-5,175,37,170,5,90,2.27917782999998,,0.2,0,-5,-10,-5,-10
1,1,82,8,1,0,0,125,179,1,98,3.33048578599994,,0.2,0,0,-1,0,-1
1,1,83,8,2,-7,38,89,26,12,76,3.88093995700001,,0.2,45,38,26,-7,-19
1,1,84,10,4,10,145,42,142,3,94,2.74828706700009,,0.2,135,145,142,10,7
1,1,85,1,1,6,6,1,5,1,98,2.61600911800019,,0.2,0,6,5,6,5
1,1,86,9,4,4,139,154,138,1,98,2.8823911070001,,0.2,135,139,138,4,3
1,1,87,9,1,-4,176,30,162,14,72,3.89824392899982,,0.2,0,-4,-18,-4,-18
1,1,88,1,2,-6,39,69,39,0,100,2.04666085299982,,0.2,45,39,39,-6,-6
1,1,89,4,2,3,48,83,55,-7,86,1.79710609200015,,0.2,45,48,55,3,10
1,1,90,7,1,0,0,39,172,8,84,3.69884001100013,,0.2,0,0,-8,0,-8
1,1,91,4,4,3,138,22,145,-7,86,2.28537951699991,,0.2,135,138,145,3,10
1,1,92,1,3,10,100,60,117,-17,66,3.64783358599993,,0.2,90,100,117,10,27
1,1,93,9,3,1,91,10,95,-4,92,3.19827350100013,,0.2,90,91,95,1,5
1,1,94,4,1,2,2,58,2,0,100,3.97972336000021,,0.2,0,2,2,2,2
1,1,95,9,2,10,55,105,44,11,78,3.31230975299991,,0.2,45,55,44,10,-1
1,1,96,3,4,-2,133,97,139,-6,88,2.23313495399998,,0.2,135,133,139,-2,4
1,1,97,6,3,-5,85,179,79,6,88,3.24767733499993,,0.2,90,85,79,-5,-11
1,1,98,6,3,-4,86,169,87,-1,98,3.36681383599989,,0.2,90,86,87,-4,-3
1,1,99,8,4,3,138,9,123,15,70,3.41407464700001,,0.2,135,138,123,3,-12
1,1,100,10,4,9,144,91,131,13,74,3.32801675099995,,0.2,135,144,131,9,-4
1,1,101,7,2,-5,40,180,32,8,84,2.33057369800008,,0.2,45,40,32,-5,-13
1,1,102,7,3,2,92,43,94,-2,96,3.5662491569999,,0.2,90,92,94,2,4
1,1,103,8,2,-2,43,1,30,13,74,2.13201822500014,,0.2,45,43,30,-2,-15
1,1,104,2,3,-9,81,76,78,3,94,2.43203171899995,,0.2,90,81,78,-9,-12
1,1,105,3,1,3,3,96,179,4,92,3.64798735599993,,0.2,0,3,-1,3,-1
1,1,106,6,2,-4,41,75,44,-3,94,1.97956317199987,,0.2,45,41,44,-4,-1
1,1,107,7,4,-10,125,58,122,3,94,2.87955058900002,,0.2,135,125,122,-10,-13
1,1,108,2,2,8,53,172,35,18,64,2.22247738700003,,0.2,45,53,35,8,-10
1,1,109,5,4,-4,131,117,122,9,82,1.50540609199993,,0.2,135,131,122,-4,-13
1,1,110,9,4,-4,131,131,131,0,100,0.914802990999988,,0.2,135,131,131,-4,-4
1,1,111,1,4,-9,126,55,120,6,88,2.666789892,,0.2,135,126,120,-9,-15
1,1,112,3,3,4,94,22,105,-11,78,3.03120827199996,,0.2,90,94,105,4,15
1,1,113,6,2,6,51,174,68,-17,66,3.61366979500008,,0.2,45,51,68,6,23
1,1,114,4,4,-6,129,104,124,5,90,1.86426824599994,,0.2,135,129,124,-6,-11
1,1,115,3,1,-8,172,52,166,6,88,2.99745095200001,,0.2,0,-8,-14,-8,-14
1,1,116,1,1,-4,176,33,171,5,90,2.14857342000005,,0.2,0,-4,-9,-4,-9
1,1,117,4,1,8,8,176,6,2,96,2.532284334,,0.2,0,8,6,8,6
1,1,118,10,1,8,8,104,11,-3,94,4.21319452500006,,0.2,0,8,11,8,11
1,1,119,8,3,-5,85,50,86,-1,98,2.96157486700008,,0.2,90,85,86,-5,-4
1,1,120,1,3,9,99,141,98,1,98,2.99790018200019,,0.2,90,99,98,9,8
1,1,121,2,3,-9,81,80,80,1,98,2.29555022599993,,0.2,90,81,80,-9,-10
1,1,122,2,1,8,8,60,12,-4,92,2.91260492099991,,0.2,0,8,12,8,12
1,1,123,6,2,0,45,164,37,8,84,2.21939130800001,,0.2,45,45,37,0,-8
1,1,124,7,2,7,52,56,52,0,100,1.36595405200001,,0.2,45,52,52,7,7
1,1,125,6,2,4,49,166,50,-1,98,2.58135250000009,,0.2,45,49,50,4,5
1,1,126,4,1,9,9,55,11,-2,96,2.0306104230001,,0.2,0,9,11,9,11
1,1,127,10,2,-7,38,174,28,10,80,2.58323892900012,,0.2,45,38,28,-7,-17
1,1,128,9,1,-1,179,136,174,5,90,1.96547407499997,,0.2,0,-1,-6,-1,-6
1,1,129,8,4,4,139,152,147,-8,84,2.63257110099994,,0.2,135,139,147,4,12
1,1,130,9,4,-2,133,81,119,14,72,1.94855022399997,,0.2,135,133,119,-2,-16
1,1,131,7,4,-4,131,107,123,8,84,1.91412251500014,,0.2,135,131,123,-4,-12
1,1,132,3,2,3,48,147,32,16,68,3.18048116499995,,0.2,45,48,32,3,-13
1,1,133,6,4,-8,127,122,122,5,90,1.03109605399982,,0.2,135,127,122,-8,-13
1,1,134,10,3,7,97,139,103,-6,88,3.03121374499983,,0.2,90,97,103,7,13
1,1,135,6,3,-3,87,112,86,1,98,2.16337160700004,,0.2,90,87,86,-3,-4
1,1,136,6,4,0,135,30,125,10,80,3.44888331699985,,0.2,135,135,125,0,-10
1,1,137,7,3,0,90,147,90,0,100,3.34878311700004,,0.2,90,90,90,0,0
1,1,138,3,2,7,52,85,51,1,98,1.89426636999997,,0.2,45,52,51,7,6
1,1,139,3,4,1,136,167,143,-7,86,1.66623125499996,,0.2,135,136,143,1,8
1,1,140,1,4,7,142,35,136,6,88,2.46662286800006,,0.2,135,142,136,7,1
1,1,141,8,1,5,5,83,9,-4,92,3.01910154799998,,0.2,0,5,9,5,9
1,1,142,3,3,-5,85,66,85,0,100,2.51388661199985,,0.2,90,85,85,-5,-5
1,1,143,1,2,3,48,33,39,9,82,1.83101487499994,,0.2,45,48,39,3,-6
1,1,144,5,1,-8,172,35,161,11,78,2.03263265500004,,0.2,0,-8,-19,-8,-19
1,1,145,5,1,2,2,20,4,-2,96,1.83070725099992,,0.2,0,2,4,2,4
1,1,146,3,3,6,96,54,99,-3,94,3.33741726099993,,0.2,90,96,99,6,9
1,1,147,8,1,-10,170,149,165,5,90,2.41421508200006,,0.2,0,-10,-15,-10,-15
1,1,148,2,4,5,140,179,156,-16,68,2.29893653599993,,0.2,135,140,156,5,21
1,1,149,9,2,1,46,126,31,15,70,3.04954417899989,,0.2,45,46,31,1,-14
1,1,150,10,1,-2,178,36,172,6,88,2.24812884399989,,0.2,0,-2,-8,-2,-8
1,1,151,7,3,9,99,99,99,0,100,0.735764225000139,,0.2,90,99,99,9,9
1,1,152,6,3,-1,89,36,87,2,96,3.01288893300011,,0.2,90,89,87,-1,-3
1,1,153,10,3,-4,86,104,86,0,100,3.46564149999995,,0.2,90,86,86,-4,-4
1,1,154,2,2,-8,37,153,24,13,74,2.43073466100009,,0.2,45,37,24,-8,-21
1,1,155,4,4,1,136,134,134,2,96,0.700066999000001,,0.2,135,136,134,1,-1
1,1,156,8,3,-8,82,119,78,4,92,2.39795995299983,,0.2,90,82,78,-8,-12
1,1,157,9,3,-2,88,147,84,4,92,2.99781550800003,,0.2,90,88,84,-2,-6
1,1,158,5,2,-9,36,116,28,8,84,3.61198873400008,,0.2,45,36,28,-9,-17
1,1,159,1,1,5,5,20,5,0,100,2.86428028299997,,0.2,0,5,5,5,5
1,1,160,2,1,2,2,178,3,-1,98,1.14801598400004,,0.2,0,2,3,2,3
2,1,1,4,4,-5,130,137,134,-4,92,0.799323067010846,,0.2,135,130,134,-5,-1
2,1,2,1,4,-3,132,85,118,14,72,1.07919031899655,,0.2,135,132,118,-3,-17
2,1,3,6,3,9,99,128,106,-7,86,1.11412189700059,,0.2,90,99,106,9,16
2,1,5,9,3,-8,82,152,85,-3,94,2.54917143800412,,0.2,90,82,85,-8,-5
2,1,6,3,1,-5,175,58,161,14,72,2.14842371499981,,0.2,0,-5,-19,-5,-19
2,1,7,9,1,-9,171,43,172,-1,98,2.083912623988,,0.2,0,-9,-8,-9,-8
2,1,8,3,1,-5,175,143,171,4,92,1.59682484500809,,0.2,0,-5,-9,-5,-9
2,1,9,7,1,-8,172,120,166,6,88,2.29642512300052,,0.2,0,-8,-14,-8,-14
2,1,10,4,2,-6,39,27,37,2,96,1.69889125198824,,0.2,45,39,37,-6,-8
2,1,11,5,3,-5,85,175,86,-1,98,3.61991565200151,,0.2,90,85,86,-5,-4
2,1,12,7,2,-6,39,52,52,-13,74,0.815839311981108,,0.2,45,39,52,-6,7
2,1,13,5,3,-7,83,26,84,-1,98,2.06643792800605,,0.2,90,83,84,-7,-6
2,1,14,5,1,4,4,3,3,1,98,0.797085099999094,,0.2,0,4,3,4,3
2,1,15,2,4,5,140,28,147,-7,86,1.86078321698005,,0.2,135,140,147,5,12
2,1,16,10,1,-2,178,139,172,6,88,1.50069243001053,,0.2,0,-2,-8,-2,-8
2,1,17,6,2,-7,38,111,38,0,100,2.86460327298846,,0.2,45,38,38,-7,-7
2,1,18,1,2,-1,44,125,43,1,98,2.73189566898509,,0.2,45,44,43,-1,-2
2,1,19,3,3,-10,80,53,78,2,96,1.30015037901467,,0.2,90,80,78,-10,-12
2,1,20,3,2,-3,42,146,48,-6,88,2.58281456000987,,0.2,45,42,48,-3,3
2,1,21,2,1,3,3,45,2,1,98,1.76490336601273,,0.2,0,3,2,3,2
2,1,22,3,2,-1,44,133,32,12,76,1.88155400200048,,0.2,45,44,32,-1,-13
2,1,23,8,3,4,94,17,100,-6,88,2.83181286000763,,0.2,90,94,100,4,10
2,1,24,4,3,3,93,91,101,-8,84,0.98094982499606,,0.2,90,93,101,3,11
2,1,25,8,4,-4,131,1,134,-3,94,1.53498631200637,,0.2,135,131,134,-4,-1
2,1,26,4,1,7,7,0,10,-3,94,0.682263154012617,,0.2,0,7,10,7,10
2,1,27,1,4,1,136,26,143,-7,86,1.71554595598718,,0.2,135,136,143,1,8
2,1,28,6,4,-2,133,108,129,4,92,1.09864020301029,,0.2,135,133,129,-2,-6
2,1,29,7,3,-4,86,76,82,4,92,0.881327484006761,,0.2,90,86,82,-4,-8
2,1,30,10,2,-3,42,158,31,11,78,1.93142130199703,,0.2,45,42,31,-3,-14
2,1,31,9,4,7,142,82,132,10,80,1.41786386800231,,0.2,135,142,132,7,-3
2,1,32,6,4,5,140,153,143,-3,94,0.832537495007273,,0.2,135,140,143,5,8
2,1,33,6,1,1,1,111,0,1,98,2.53002933500102,,0.2,0,1,0,1,0
2,1,34,4,4,5,140,123,135,5,90,0.893216539989226,,0.2,135,140,135,5,0
2,1,35,2,3,-5,85,91,82,3,94,0.816336869000224,,0.2,90,85,82,-5,-8
2,1,36,2,1,-5,175,129,172,3,94,1.19770316799986,,0.2,0,-5,-8,-5,-8
2,1,37,9,2,-7,38,119,34,4,92,1.98188196698902,,0.2,45,38,34,-7,-11
2,1,38,9,2,8,53,131,54,-1,98,2.53178464598022,,0.2,45,53,54,8,9
2,1,39,2,3,-8,82,99,84,-2,96,0.949242216011044,,0.2,90,82,84,-8,-6
2,1,40,8,1,1,1,102,2,-1,98,2.74557269198704,,0.2,0,1,2,1,2
2,1,41,10,4,4,139,29,133,6,88,2.26562211601413,,0.2,135,139,133,4,-2
2,1,42,10,1,8,8,77,23,-15,70,2.09848336901632,,0.2,0,8,23,8,23
2,1,43,5,1,8,8,92,8,0,100,2.68105885398109,,0.2,0,8,8,8,8
2,1,44,2,4,6,141,176,146,-5,90,1.41465244098799,,0.2,135,141,146,6,11
2,1,45,7,2,-1,44,87,64,-20,60,1.26608844500151,,0.2,45,44,64,-1,19
2,1,46,5,1,4,4,8,3,1,98,0.933122515009018,,0.2,0,4,3,4,3
2,1,47,9,3,6,96,125,103,-7,86,1.36509661300806,,0.2,90,96,103,6,13
2,1,48,8,3,-7,83,133,88,-5,90,2.30999055100256,,0.2,90,83,88,-7,-2
2,1,49,1,1,4,4,88,9,-5,90,2.36473623997881,,0.2,0,4,9,4,9
2,1,50,10,3,-2,88,122,89,-1,98,1.64943164100987,,0.2,90,88,89,-2,-1
2,1,51,10,3,10,100,19,106,-6,88,2.24741652500234,,0.2,90,100,106,10,16
2,1,52,5,3,1,91,37,92,-1,98,2.21227966801962,,0.2,90,91,92,1,2
2,1,53,3,1,2,2,3,3,-1,98,0.647926456003916,,0.2,0,2,3,2,3
2,1,54,3,1,-7,173,64,168,5,90,2.83345428100438,,0.2,0,-7,-12,-7,-12
2,1,55,3,3,3,93,162,95,-2,96,2.43029675097205,,0.2,90,93,95,3,5
2,1,56,8,3,2,92,49,95,-3,94,1.64711582899326,,0.2,90,92,95,2,5
2,1,57,10,2,-7,38,78,51,-13,74,1.03413763601566,,0.2,45,38,51,-7,6
2,1,58,9,4,-5,130,47,129,1,98,1.93060492302175,,0.2,135,130,129,-5,-6
2,1,59,8,4,-2,133,80,132,1,98,1.42882401400129,,0.2,135,133,132,-2,-3
2,1,60,7,2,-8,37,68,46,-9,82,1.06426087001455,,0.2,45,37,46,-8,1
2,1,61,4,2,1,46,148,49,-3,94,2.13032306698733,,0.2,45,46,49,1,4
2,1,62,3,3,8,98,47,105,-7,86,1.47017123099067,,0.2,90,98,105,8,15
2,1,63,1,3,2,92,152,95,-3,94,1.93194221399608,,0.2,90,92,95,2,5
2,1,64,6,3,-2,88,164,87,1,98,2.64752755902009,,0.2,90,88,87,-2,-3
2,1,65,7,4,0,135,101,132,3,94,1.24571585800732,,0.2,135,135,132,0,-3
2,1,66,5,2,6,51,170,40,11,78,1.29633399299928,,0.2,45,51,40,6,-5
2,1,67,6,3,1,91,23,91,0,100,2.11500751800486,,0.2,90,91,91,1,1
2,1,68,7,1,2,2,71,2,0,100,2.64861969900085,,0.2,0,2,2,2,2
2,1,69,4,3,0,90,176,91,-1,98,3.10142794501735,,0.2,90,90,91,0,1
2,1,70,9,3,-6,84,128,88,-4,92,2.71590448499774,,0.2,90,84,88,-6,-2
2,1,71,10,3,0,90,26,91,-1,98,2.53058000400779,,0.2,90,90,91,0,1
2,1,72,4,2,3,48,88,51,-3,94,1.2611251839844,,0.2,45,48,51,3,6
2,1,73,2,4,1,136,125,125,11,78,0.631605670001591,,0.2,135,136,125,1,-10
2,1,74,1,1,5,5,85,9,-4,92,2.1978986109898,,0.2,0,5,9,5,9
2,1,75,4,4,-5,130,135,135,-5,90,0.719966795993969,,0.2,135,130,135,-5,0
2,1,76,6,3,-8,82,33,67,15,70,0.934722726000473,,0.2,90,82,67,-8,-23
2,1,77,10,4,-1,134,44,130,4,92,2.04943588800961,,0.2,135,134,130,-1,-5
2,1,78,6,1,-4,176,4,164,12,76,0.812973300024169,,0.2,0,-4,-16,-4,-16
2,1,79,6,4,-3,132,167,142,-10,80,1.11389240098651,,0.2,135,132,142,-3,7
2,1,80,8,1,-2,178,21,178,0,100,1.71661944699008,,0.2,0,-2,-2,-2,-2
2,1,81,8,2,-9,36,12,43,-7,86,1.08133889501914,,0.2,45,36,43,-9,-2
2,1,82,6,2,-6,39,88,57,-18,64,1.23659249598859,,0.2,45,39,57,-6,12
2,1,83,2,1,4,4,119,10,-6,88,2.10002179199364,,0.2,0,4,10,4,10
2,1,84,8,3,-6,84,121,84,0,100,1.3826211069827,,0.2,90,84,84,-6,-6
2,1,85,9,4,-1,134,30,127,7,86,2.38078867300646,,0.2,135,134,127,-1,-8
2,1,86,8,4,-5,130,118,129,1,98,0.732623942982173,,0.2,135,130,129,-5,-6
2,1,87,4,1,7,7,114,8,-1,98,2.23689108502003,,0.2,0,7,8,7,8
2,1,88,10,2,2,47,151,34,13,74,1.61827016400639,,0.2,45,47,34,2,-11
2,1,89,5,4,3,138,61,143,-5,90,2.23145083198324,,0.2,135,138,143,3,8
2,1,90,4,3,9,99,73,104,-5,90,1.76374328098609,,0.2,90,99,104,9,14
2,1,91,6,1,1,1,39,0,1,98,1.58158380098757,,0.2,0,1,0,1,0
2,1,92,1,1,5,5,117,6,-1,98,2.10656581798685,,0.2,0,5,6,5,6
2,1,93,6,4,9,144,99,145,-1,98,1.5709641299909,,0.2,135,144,145,9,10
2,1,94,4,1,5,5,83,179,6,88,2.74726467998698,,0.2,0,5,-1,5,-1
2,1,95,3,2,-2,43,176,36,7,86,1.28338111899211,,0.2,45,43,36,-2,-9
2,1,96,6,2,-9,36,124,33,3,94,2.03171877600835,,0.2,45,36,33,-9,-12
2,1,97,5,4,7,142,10,147,-5,90,1.12825571798021,,0.2,135,142,147,7,12
2,1,98,4,2,5,50,62,70,-20,60,1.03097506597987,,0.2,45,50,70,5,25
2,1,99,2,2,-10,35,95,44,-9,82,1.34867722800118,,0.2,45,35,44,-10,-1
2,1,100,8,4,-4,131,40,130,1,98,1.96555125099258,,0.2,135,131,130,-4,-5
2,1,101,5,2,9,54,143,56,-2,96,2.0972700350103,,0.2,45,54,56,9,11
2,1,102,5,1,-7,173,24,159,14,72,1.5814090819913,,0.2,0,-7,-21,-7,-21
2,1,103,8,2,2,47,131,50,-3,94,2.77895954999258,,0.2,45,47,50,2,5
2,1,104,7,1,5,5,126,11,-6,88,2.11320805997821,,0.2,0,5,11,5,11
2,1,105,1,2,-9,36,160,25,11,78,1.09097729899804,,0.2,45,36,25,-9,-20
2,1,106,1,3,0,90,162,91,-1,98,2.69847718899837,,0.2,90,90,91,0,1
2,1,107,8,2,-4,41,22,33,8,84,0.668048577004811,,0.2,45,41,33,-4,-12
2,1,108,1,1,8,8,95,12,-4,92,2.61832432702067,,0.2,0,8,12,8,12
2,1,109,5,4,9,144,43,124,20,60,1.66224273599801,,0.2,135,144,124,9,-11
2,1,110,3,4,-9,126,80,117,9,82,0.999440505984239,,0.2,135,126,117,-9,-18
2,1,111,2,3,1,91,76,88,3,94,1.33381958401878,,0.2,90,91,88,1,-2
2,1,112,9,1,-6,174,58,159,15,70,2.21401409502141,,0.2,0,-6,-21,-6,-21
2,1,113,4,3,-7,83,62,80,3,94,1.14874608599348,,0.2,90,83,80,-7,-10
2,1,114,5,3,1,91,52,91,0,100,2.03230350499507,,0.2,90,91,91,1,1
2,1,115,2,4,-6,129,100,115,14,72,0.930383833008818,,0.2,135,129,115,-6,-20
2,1,116,1,2,6,51,148,56,-5,90,3.13087879298837,,0.2,45,51,56,6,11
2,1,117,3,2,3,48,150,39,9,82,2.33087980700657,,0.2,45,48,39,3,-6
2,1,118,3,4,0,135,120,139,-4,92,0.783111880999058,,0.2,135,135,139,0,4
2,1,119,3,4,-5,130,3,136,-6,88,1.74707458401099,,0.2,135,130,136,-5,1
2,1,120,10,1,-5,175,44,177,-2,96,2.51502301299479,,0.2,0,-5,-3,-5,-3
2,1,121,7,3,8,98,53,100,-2,96,3.18035508299363,,0.2,90,98,100,8,10
2,1,122,9,1,-5,175,18,178,-3,94,2.82759178199922,,0.2,0,-5,-2,-5,-2
2,1,123,7,2,10,55,44,54,1,98,1.23285895201843,,0.2,45,55,54,10,9
2,1,124,7,3,3,93,142,95,-2,96,2.36505044001387,,0.2,90,93,95,3,5
2,1,125,8,1,9,9,175,8,1,98,1.4644803830015,,0.2,0,9,8,9,8
2,1,126,5,4,4,139,173,145,-6,88,2.26472856200417,,0.2,135,139,145,4,10
2,1,127,5,2,-6,39,123,40,-1,98,2.31568502698792,,0.2,45,39,40,-6,-5
2,1,128,1,2,3,48,45,41,7,86,0.864272506994894,,0.2,45,48,41,3,-4
2,1,129,9,2,8,53,96,54,-1,98,1.6805422269972,,0.2,45,53,54,8,9
2,1,130,2,2,9,54,64,52,2,96,0.780029262008611,,0.2,45,54,52,9,7
2,1,131,9,1,1,1,127,1,0,100,2.51552342099603,,0.2,0,1,1,1,1
2,1,132,7,4,1,136,21,140,-4,92,2.08051783399424,,0.2,135,136,140,1,5
2,1,133,7,4,-5,130,32,134,-4,92,2.6002414500108,,0.2,135,130,134,-5,-1
2,1,134,2,2,3,48,157,53,-5,90,1.84865240097861,,0.2,45,48,53,3,8
2,1,135,8,2,8,53,14,48,5,90,1.17910379698151,,0.2,45,53,48,8,3
2,1,136,1,4,-2,133,122,137,-4,92,0.83303627098212,,0.2,135,133,137,-2,2
2,1,137,7,1,10,10,152,10,0,100,1.08233258200926,,0.2,0,10,10,10,10
2,1,138,2,1,9,9,17,8,1,98,1.22178748997976,,0.2,0,9,8,9,8
2,1,139,4,1,-1,179,47,178,1,98,3.0152539559931,,0.2,0,-1,-2,-1,-2
2,1,140,1,3,-2,88,137,89,-1,98,2.16551728898776,,0.2,90,88,89,-2,-1
2,1,141,8,1,-7,173,122,179,-6,88,2.06200934399385,,0.2,0,-7,-1,-7,-1
2,1,142,4,4,0,135,145,135,0,100,1.46387986102491,,0.2,135,135,135,0,0
2,1,143,9,3,-9,81,72,78,3,94,0.697725731006358,,0.2,90,81,78,-9,-12
2,1,144,2,3,-8,82,158,86,-4,92,2.22002891200827,,0.2,90,82,86,-8,-4
2,1,145,10,1,4,4,48,3,1,98,1.86776763701346,,0.2,0,4,3,4,3
2,1,146,7,3,8,98,32,99,-1,98,2.24873463300173,,0.2,90,98,99,8,9
2,1,147,6,2,7,52,48,48,4,92,0.63286395999603,,0.2,45,52,48,7,3
2,1,148,10,3,0,90,178,91,-1,98,3.41472029098077,,0.2,90,90,91,0,1
2,1,149,3,3,-10,80,162,78,2,96,2.42149498299113,,0.2,90,80,78,-10,-12
2,1,150,7,4,0,135,135,128,7,86,2.24792610399891,,0.2,135,135,128,0,-7
2,1,151,10,4,7,142,61,142,0,100,2.18237594800303,,0.2,135,142,142,7,7
2,1,152,9,4,-5,130,156,133,-3,94,0.983961360994726,,0.2,135,130,133,-5,-2
2,1,153,9,2,-7,38,129,35,3,94,1.83222434899653,,0.2,45,38,35,-7,-10
2,1,154,6,1,8,8,130,11,-3,94,1.84552485201857,,0.2,0,8,11,8,11
2,1,155,1,4,6,141,83,134,7,86,1.38183490801021,,0.2,135,141,134,6,-1
2,1,156,3,4,6,141,127,149,-8,84,0.949793029023567,,0.2,135,141,149,6,14
2,1,157,10,2,5,50,14,48,2,96,0.983052041003248,,0.2,45,50,48,5,3
2,1,158,1,3,-8,82,15,84,-2,96,1.66774764598813,,0.2,90,82,84,-8,-6
2,1,159,2,2,1,46,32,40,6,88,0.815219601005083,,0.2,45,46,40,1,-5
2,1,160,10,4,1,136,95,139,-3,94,1.19046956099919,,0.2,135,136,139,1,4
3,1,1,8,1,6,6,175,19,-13,74,1.64887968206313,,0.2,0,6,19,6,19
3,1,2,1,2,4,49,46,45,4,92,1.31824488996062,,0.2,45,49,45,4,0
3,1,3,6,4,-10,125,113,117,8,84,1.73271214403212,,0.2,135,125,117,-10,-18
3,1,4,1,1,7,7,164,6,1,98,2.56239928700961,,0.2,0,7,6,7,6
3,1,5,4,2,-7,38,35,34,4,92,1.14757285593078,,0.2,45,38,34,-7,-11
3,1,6,1,4,0,135,23,144,-9,82,2.78283610893413,,0.2,135,135,144,0,9
3,1,7,5,1,-8,172,83,165,7,86,3.89681939501315,,0.2,0,-8,-15,-8,-15
3,1,8,5,2,-8,37,0,36,1,98,1.63460306101479,,0.2,45,37,36,-8,-9
3,1,9,2,3,3,93,150,96,-3,94,3.46497191896196,,0.2,90,93,96,3,6
3,1,10,3,1,-9,171,162,165,6,88,1.31547862908337,,0.2,0,-9,-15,-9,-15
3,1,11,5,1,3,3,35,4,-1,98,2.76460240792949,,0.2,0,3,4,3,4
3,1,12,3,1,-1,179,178,178,1,98,1.45759222796187,,0.2,0,-1,-2,-1,-2
3,1,13,1,3,-9,81,19,84,-3,94,2.58245281304698,,0.2,90,81,84,-9,-6
3,1,14,9,4,-8,127,4,139,-12,76,2.13217434298713,,0.2,135,127,139,-8,4
3,1,15,3,1,3,3,128,5,-2,96,2.66556322993711,,0.2,0,3,5,3,5
3,1,16,8,2,-9,36,58,39,-3,94,1.69912576593924,,0.2,45,36,39,-9,-6
3,1,17,9,2,-2,43,41,35,8,84,1.99689156294335,,0.2,45,43,35,-2,-10
3,1,18,8,4,-1,134,158,133,1,98,1.61357598798349,,0.2,135,134,133,-1,-2
3,1,19,4,3,-3,87,64,86,1,98,2.36432274605613,,0.2,90,87,86,-3,-4
3,1,20,10,3,9,99,150,97,2,96,2.89846140309237,,0.2,90,99,97,9,7
3,1,21,8,2,3,48,4,33,15,70,2.39879354194272,,0.2,45,48,33,3,-12
3,1,22,6,2,-10,35,7,33,2,96,1.58084830199368,,0.2,45,35,33,-10,-12
3,1,23,7,2,-6,39,32,31,8,84,1.04569272999652,,0.2,45,39,31,-6,-14
3,1,24,8,4,4,139,50,145,-6,88,3.13134042196907,,0.2,135,139,145,4,10
3,1,25,10,4,-4,131,152,133,-2,96,1.99721047305502,,0.2,135,131,133,-4,-2
3,1,26,6,2,-8,37,178,31,6,88,1.94741103006527,,0.2,45,37,31,-8,-14
3,1,27,9,2,7,52,90,50,2,96,2.64865820796695,,0.2,45,52,50,7,5
3,1,28,8,2,-4,41,49,43,-2,96,1.44848331494723,,0.2,45,41,43,-4,-2
3,1,29,5,4,-10,125,100,115,10,80,1.02973922691308,,0.2,135,125,115,-10,-20
3,1,30,4,4,-7,128,82,119,9,82,2.64776551595423,,0.2,135,128,119,-7,-16
3,1,31,10,2,-4,41,20,41,0,100,1.51383133395575,,0.2,45,41,41,-4,-4
3,1,32,10,4,-6,129,75,124,5,90,2.18054013303481,,0.2,135,129,124,-6,-11
3,1,33,8,3,4,94,118,98,-4,92,2.38184548006393,,0.2,90,94,98,4,8
3,1,34,2,1,0,0,28,0,0,100,4.46425391291268,,0.2,0,0,0,0,0
3,1,35,7,2,9,54,28,43,11,78,2.2141042429721,,0.2,45,54,43,9,-2
3,1,36,4,4,8,143,57,157,-14,72,2.93096903094556,,0.2,135,143,157,8,22
3,1,37,5,2,-2,43,24,32,11,78,2.16508227901068,,0.2,45,43,32,-2,-13
3,1,38,2,4,3,138,12,142,-4,92,1.99766464100685,,0.2,135,138,142,3,7
3,1,39,1,4,6,141,141,142,-1,98,1.84776784502901,,0.2,135,141,142,6,7
3,1,40,6,1,7,7,180,6,1,98,2.66579560108948,,0.2,0,7,6,7,6
3,1,41,5,3,-2,88,130,89,-1,98,2.96336549799889,,0.2,90,88,89,-2,-1
3,1,42,4,2,4,49,123,32,17,66,3.21102978300769,,0.2,45,49,32,4,-13
3,1,43,2,4,1,136,73,139,-3,94,4.42919488099869,,0.2,135,136,139,1,4
3,1,44,2,2,-9,36,121,41,-5,90,3.98100097896531,,0.2,45,36,41,-9,-4
3,1,45,5,4,9,144,32,149,-5,90,2.23032973892987,,0.2,135,144,149,9,14
3,1,46,1,1,5,5,12,12,-7,86,1.04876087896992,,0.2,0,5,12,5,12
3,1,47,7,2,-3,42,21,40,2,96,2.83049266901799,,0.2,45,42,40,-3,-5
3,1,48,1,3,-2,88,124,86,2,96,1.94553947402164,,0.2,90,88,86,-2,-4
3,1,49,9,2,3,48,124,60,-12,76,2.53092237596866,,0.2,45,48,60,3,15
3,1,50,2,2,6,51,108,63,-12,76,2.78270111000165,,0.2,45,51,63,6,18
3,1,51,2,1,-2,178,166,0,-2,96,2.89827439992223,,0.2,0,-2,0,-2,0
3,1,52,3,2,2,47,170,41,6,88,3.06705671700183,,0.2,45,47,41,2,-4
3,1,53,3,4,-9,126,105,120,6,88,3.3165309720207,,0.2,135,126,120,-9,-15
3,1,55,1,2,3,48,60,54,-6,88,1.61114243394695,,0.2,45,48,54,3,9
3,1,56,8,4,-1,134,112,134,0,100,2.6716429250082,,0.2,135,134,134,-1,-1
3,1,57,1,2,-6,39,20,37,2,96,2.246732018888,,0.2,45,39,37,-6,-8
3,1,58,2,4,-4,131,159,142,-11,78,1.54934846400283,,0.2,135,131,142,-4,7
3,1,59,6,4,3,138,85,118,20,60,2.03336959006265,,0.2,135,138,118,3,-17
3,1,60,2,3,4,94,105,96,-2,96,1.61430333100725,,0.2,90,94,96,4,6
3,1,61,1,2,6,51,26,50,1,98,2.0459592390107,,0.2,45,51,50,6,5
3,1,62,5,3,-3,87,16,87,0,100,2.77948597900104,,0.2,90,87,87,-3,-3
3,1,63,6,3,5,95,8,98,-3,94,3.24656501901336,,0.2,90,95,98,5,8
3,1,64,9,1,2,2,78,3,-1,98,3.41542797000147,,0.2,0,2,3,2,3
3,1,65,8,1,8,8,178,17,-9,82,1.38499831990339,,0.2,0,8,17,8,17
3,1,66,10,1,5,5,151,18,-13,74,2.99842988408636,,0.2,0,5,18,5,18
3,1,67,9,1,1,1,14,1,0,100,2.44647029298358,,0.2,0,1,1,1,1
3,1,68,6,3,4,94,167,92,2,96,3.66433304199018,,0.2,90,94,92,4,2
3,1,69,7,1,8,8,3,10,-2,96,1.81564661499579,,0.2,0,8,10,8,10
3,1,70,10,3,1,91,1,93,-2,96,4.36549224192277,,0.2,90,91,93,1,3
3,1,71,4,2,9,54,68,61,-7,86,1.98541389510501,,0.2,45,54,61,9,16
3,1,72,4,1,-6,174,101,168,6,88,3.54813383391593,,0.2,0,-6,-12,-6,-12
3,1,73,3,3,7,97,13,102,-5,90,3.83210174704436,,0.2,90,97,102,7,12
3,1,74,10,2,2,47,126,32,15,70,3.0798158190446,,0.2,45,47,32,2,-13
3,1,75,5,1,2,2,165,11,-9,82,2.23087009100709,,0.2,0,2,11,2,11
3,1,77,10,1,2,2,14,5,-3,94,1.43186801800039,,0.2,0,2,5,2,5
3,1,78,9,2,0,45,138,31,14,72,2.5845443130238,,0.2,45,45,31,0,-14
3,1,79,10,3,-6,84,164,83,1,98,2.84756700997241,,0.2,90,84,83,-6,-7
3,1,80,9,3,0,90,144,89,1,98,2.77836591599043,,0.2,90,90,89,0,-1
3,1,81,9,1,4,4,7,7,-3,94,0.730633769999258,,0.2,0,4,7,4,7
3,1,82,5,2,6,51,168,49,2,96,2.53343584190588,,0.2,45,51,49,6,4
3,1,83,7,3,1,91,85,94,-3,94,2.3822893690085,,0.2,90,91,94,1,4
3,1,84,9,3,10,100,64,99,1,98,2.91448922001291,,0.2,90,100,99,10,9
3,1,85,9,4,-6,129,169,137,-8,84,1.93159917893354,,0.2,135,129,137,-6,2
3,1,86,5,1,-9,171,155,170,1,98,1.23028876294848,,0.2,0,-9,-10,-9,-10
3,1,87,9,4,7,142,13,149,-7,86,1.61396619293373,,0.2,135,142,149,7,14
3,1,88,2,4,-4,131,159,138,-7,86,2.11284949805122,,0.2,135,131,138,-4,3
3,1,89,8,1,4,4,14,5,-1,98,2.13105187797919,,0.2,0,4,5,4,5
3,1,90,4,1,-9,171,27,165,6,88,1.98359666194301,,0.2,0,-9,-15,-9,-15
3,1,91,8,4,-1,134,35,132,2,96,3.66604447807185,,0.2,135,134,132,-1,-3
3,1,92,6,3,7,97,134,97,0,100,2.14547773194499,,0.2,90,97,97,7,7
3,1,93,7,3,9,99,160,100,-1,98,2.66501889401115,,0.2,90,99,100,9,10
3,1,94,4,3,3,93,3,94,-1,98,3.05466955609154,,0.2,90,93,94,3,4
3,1,95,10,2,-1,44,55,38,6,88,1.53181344794575,,0.2,45,44,38,-1,-7
3,1,96,4,3,5,95,34,103,-8,84,2.9145020119613,,0.2,90,95,103,5,13
3,1,97,4,2,-3,42,115,34,8,84,3.19912823301274,,0.2,45,42,34,-3,-11
3,1,99,7,2,1,46,40,40,6,88,0.580281139002182,,0.2,45,46,40,1,-5
3,1,100,10,2,4,49,68,44,5,90,2.99513861793093,,0.2,45,49,44,4,-1
3,1,101,6,1,10,10,165,19,-9,82,1.88037333800457,,0.2,0,10,19,10,19
3,1,102,1,4,-1,134,22,141,-7,86,3.95237605902366,,0.2,135,134,141,-1,6
3,1,103,3,4,0,135,12,132,3,94,2.51501206494868,,0.2,135,135,132,0,-3
3,1,104,2,2,5,50,172,49,1,98,2.14746152504813,,0.2,45,50,49,5,4
3,1,105,3,1,7,7,105,14,-7,86,3.14534648193512,,0.2,0,7,14,7,14
3,1,106,1,3,-8,82,176,84,-2,96,3.64599786396138,,0.2,90,82,84,-8,-6
3,1,107,7,3,6,96,176,92,4,92,3.79869944497477,,0.2,90,96,92,6,2
3,1,108,10,1,-9,171,15,175,-4,92,2.93084714596625,,0.2,0,-9,-5,-9,-5
3,1,110,3,2,-10,35,176,33,2,96,1.83297843497712,,0.2,45,35,33,-10,-12
3,1,111,5,2,-2,43,104,40,3,94,3.74562660092488,,0.2,45,43,40,-2,-5
3,1,112,8,2,1,46,142,27,19,62,3.31415911507793,,0.2,45,46,27,1,-18
3,1,113,2,1,2,2,153,7,-5,90,1.80452415300533,,0.2,0,2,7,2,7
3,1,114,7,4,-4,131,28,129,2,96,3.01347529992927,,0.2,135,131,129,-4,-6
3,1,115,8,3,-9,81,85,77,4,92,1.96406146197114,,0.2,90,81,77,-9,-13
3,1,116,3,4,-4,131,119,141,-10,80,2.41544289700687,,0.2,135,131,141,-4,6
3,1,117,7,1,4,4,177,7,-3,94,1.88304007507395,,0.2,0,4,7,4,7
3,1,118,6,2,-4,41,152,34,7,86,2.51493312104139,,0.2,45,41,34,-4,-11
3,1,119,9,3,1,91,145,90,1,98,3.16209636605345,,0.2,90,91,90,1,0
3,1,120,9,1,9,9,115,16,-7,86,3.68234897695947,,0.2,0,9,16,9,16
3,1,121,10,1,-3,177,137,178,-1,98,2.55402951408178,,0.2,0,-3,-2,-3,-2
3,1,122,2,3,-2,88,96,88,0,100,3.13358247303404,,0.2,90,88,88,-2,-2
3,1,123,6,4,-9,126,6,144,-18,64,2.03204147005454,,0.2,135,126,144,-9,9
3,1,124,5,3,10,100,145,113,-13,74,2.54419679404236,,0.2,90,100,113,10,23
3,1,125,5,3,-6,84,103,86,-2,96,3.51279807696119,,0.2,90,84,86,-6,-4
3,1,126,3,3,-4,86,68,86,0,100,2.27273570105899,,0.2,90,86,86,-4,-4
3,1,127,10,4,-6,129,122,133,-4,92,1.73156414600089,,0.2,135,129,133,-6,-2
3,1,128,6,4,-4,131,14,148,-17,66,2.98534961196128,,0.2,135,131,148,-4,13
3,1,129,7,1,6,6,126,16,-10,80,3.41472956095822,,0.2,0,6,16,6,16
3,1,130,2,1,-7,173,110,171,2,96,3.06175719806924,,0.2,0,-7,-9,-7,-9
3,1,131,10,4,-5,130,25,151,-21,58,2.94833109294996,,0.2,135,130,151,-5,16
3,1,132,9,3,-9,81,30,87,-6,88,2.85707863792777,,0.2,90,81,87,-9,-3
3,1,133,4,1,2,2,64,2,0,100,2.96581740595866,,0.2,0,2,2,2,2
3,1,134,7,1,-4,176,70,178,-2,96,3.90181949804537,,0.2,0,-4,-2,-4,-2
3,1,135,6,1,5,5,98,13,-8,84,3.38178601593245,,0.2,0,5,13,5,13
3,1,136,3,4,3,138,45,139,-1,98,3.43155263608787,,0.2,135,138,139,3,4
3,1,137,4,4,7,142,53,136,6,88,3.23101861297619,,0.2,135,142,136,7,1
3,1,138,6,1,-9,171,11,161,10,80,1.79702854796778,,0.2,0,-9,-19,-9,-19
3,1,139,1,3,5,95,53,96,-1,98,2.28229522402398,,0.2,90,95,96,5,6
3,1,140,3,3,6,96,7,94,2,96,3.61630529398099,,0.2,90,96,94,6,4
3,1,141,3,2,0,45,155,31,14,72,2.23255373095162,,0.2,45,45,31,0,-14
3,1,142,8,3,6,96,51,98,-2,96,2.69999027706217,,0.2,90,96,98,6,8
3,1,143,5,4,-2,133,22,142,-9,82,2.98257411993109,,0.2,135,133,142,-2,7
3,1,144,6,3,2,92,75,94,-2,96,2.94593975902535,,0.2,90,92,94,2,4
3,1,145,1,1,7,7,179,9,-2,96,1.89900371804833,,0.2,0,7,9,7,9
3,1,146,8,3,2,92,121,93,-1,98,3.16479881107807,,0.2,90,92,93,2,3
3,1,147,6,2,5,50,54,61,-11,78,2.16699206398334,,0.2,45,50,61,5,16
3,1,148,4,4,9,144,88,134,10,80,2.88180656905752,,0.2,135,144,134,9,-1
3,1,149,7,4,9,144,129,164,-20,60,2.91247089300305,,0.2,135,144,164,9,29
3,1,150,8,1,4,4,142,14,-10,80,2.1486476449063,,0.2,0,4,14,4,14
3,1,151,1,1,8,8,3,9,-1,98,1.28178120404482,,0.2,0,8,9,8,9
3,1,152,4,1,-5,175,80,171,4,92,2.88718542899005,,0.2,0,-5,-9,-5,-9
3,1,153,5,4,-1,134,163,133,1,98,2.08139231300447,,0.2,135,134,133,-1,-2
3,1,154,7,4,-6,129,141,139,-10,80,1.66777711501345,,0.2,135,129,139,-6,4
3,1,155,7,4,6,141,147,143,-2,96,1.41332709998824,,0.2,135,141,143,6,8
3,1,156,3,2,-3,42,25,37,5,90,2.09370551491156,,0.2,45,42,37,-3,-8
3,1,157,2,2,-2,43,7,39,4,92,2.29749360692222,,0.2,45,43,39,-2,-6
3,1,158,1,4,1,136,176,144,-8,84,2.04726546409074,,0.2,135,136,144,1,9
3,1,159,4,3,9,99,130,102,-3,94,2.98171007295605,,0.2,90,99,102,9,12
3,1,160,10,3,1,91,121,87,4,92,2.78049312904477,,0.2,90,91,87,1,-3
4,1,2,3,1,-9,171,85,165,6,88,2.64127562400063,,0.2,0,-9,-15,-9,-15
4,1,3,4,2,-1,44,58,40,4,92,1.03899904299942,,0.2,45,44,40,-1,-5
4,1,4,1,3,6,96,12,109,-13,74,3.02613522200045,,0.2,90,96,109,6,19
4,1,5,3,4,3,138,43,141,-3,94,3.07683618999909,,0.2,135,138,141,3,6
4,1,6,7,1,-9,171,152,171,0,100,1.06971420599984,,0.2,0,-9,-9,-9,-9
4,1,7,2,3,2,92,158,95,-3,94,2.39185148099932,,0.2,90,92,95,2,5
4,1,8,9,1,7,7,25,10,-3,94,0.99205406100009,,0.2,0,7,10,7,10
4,1,9,1,2,8,53,112,51,2,96,2.39744439599963,,0.2,45,53,51,8,6
4,1,10,5,4,7,142,70,147,-5,90,3.11218873100006,,0.2,135,142,147,7,12
4,1,11,9,2,7,52,80,46,6,88,1.51194390199998,,0.2,45,52,46,7,1
4,1,12,2,2,-6,39,112,40,-1,98,2.5401446449996,,0.2,45,39,40,-6,-5
4,1,13,10,2,9,54,76,48,6,88,1.33895163499983,,0.2,45,54,48,9,3
4,1,14,9,1,10,10,69,8,2,96,2.1913267150012,,0.2,0,10,8,10,8
4,1,15,5,4,4,139,115,157,-18,64,1.64637388600022,,0.2,135,139,157,4,22
4,1,16,5,1,7,7,178,14,-7,86,1.70291421199909,,0.2,0,7,14,7,14
4,1,17,3,2,9,54,3,44,10,80,1.5461830180011,,0.2,45,54,44,9,-1
4,1,18,7,4,-4,131,128,128,3,94,0.952349511999273,,0.2,135,131,128,-4,-7
4,1,19,4,3,-3,87,27,84,3,94,2.03824917400016,,0.2,90,87,84,-3,-6
4,1,20,4,2,7,52,24,50,2,96,1.17462179199902,,0.2,45,52,50,7,5
4,1,21,9,3,-5,85,16,76,9,82,1.99125786300101,,0.2,90,85,76,-5,-14
4,1,22,8,2,8,53,55,55,-2,96,1.42277877199922,,0.2,45,53,55,8,10
4,1,23,5,3,-9,81,80,78,3,94,2.07977681000011,,0.2,90,81,78,-9,-12
4,1,24,1,1,9,9,166,15,-6,88,1.7888374310005,,0.2,0,9,15,9,15
4,1,25,1,4,-7,128,25,139,-11,78,3.6685390269995,,0.2,135,128,139,-7,4
4,1,27,4,3,3,93,18,93,0,100,2.40026969300015,,0.2,90,93,93,3,3
4,1,28,10,1,-4,176,134,174,2,96,1.54084743299973,,0.2,0,-4,-6,-4,-6
4,1,29,6,1,5,5,20,179,6,88,1.18566969800122,,0.2,0,5,-1,5,-1
4,1,30,4,1,4,4,126,10,-6,88,2.10235974500029,,0.2,0,4,10,4,10
4,1,31,7,2,-2,43,117,44,-1,98,3.29676024600121,,0.2,45,43,44,-2,-1
4,1,32,7,2,1,46,61,43,3,94,1.45136686200021,,0.2,45,46,43,1,-2
4,1,33,3,4,-8,127,9,130,-3,94,2.06509432599887,,0.2,135,127,130,-8,-5
4,1,34,10,3,9,99,76,112,-13,74,1.67707646300005,,0.2,90,99,112,9,22
4,1,35,6,1,10,10,105,11,-1,98,2.81192102299974,,0.2,0,10,11,10,11
4,1,36,1,4,-8,127,72,139,-12,76,3.65279245900092,,0.2,135,127,139,-8,4
4,1,37,7,3,5,95,42,103,-8,84,3.60501087100056,,0.2,90,95,103,5,13
4,1,38,2,4,1,136,44,136,0,100,3.98447713499991,,0.2,135,136,136,1,1
4,1,39,8,2,-6,39,161,33,6,88,2.9883703200012,,0.2,45,39,33,-6,-12
4,1,40,5,3,0,90,134,96,-6,88,2.24652081699969,,0.2,90,90,96,0,6
4,1,41,5,3,-5,85,139,89,-4,92,2.66700641399984,,0.2,90,85,89,-5,-1
4,1,42,8,3,-1,89,80,89,0,100,1.66141677300038,,0.2,90,89,89,-1,-1
4,1,44,8,4,-10,125,118,125,0,100,1.156227432999,,0.2,135,125,125,-10,-10
4,1,45,5,3,5,95,53,98,-3,94,1.71855636700093,,0.2,90,95,98,5,8
4,1,46,10,4,2,137,13,147,-10,80,1.95373044900043,,0.2,135,137,147,2,12
4,1,47,2,1,9,9,85,10,-1,98,2.69033461300023,,0.2,0,9,10,9,10
4,1,48,7,1,-9,171,162,172,-1,98,1.74505836599928,,0.2,0,-9,-8,-9,-8
4,1,49,4,3,-6,84,25,86,-2,96,3.23500072899878,,0.2,90,84,86,-6,-4
4,1,51,2,2,-2,43,16,43,0,100,2.19164201499916,,0.2,45,43,43,-2,-2
4,1,52,6,4,-7,128,128,133,-5,90,1.06255188399882,,0.2,135,128,133,-7,-2
4,1,53,9,3,-8,82,122,71,11,78,1.87273267199998,,0.2,90,82,71,-8,-19
4,1,54,3,1,-2,178,137,175,3,94,2.00685235399942,,0.2,0,-2,-5,-2,-5
4,1,55,2,4,3,138,123,148,-10,80,1.89976740900056,,0.2,135,138,148,3,13
4,1,56,8,3,-8,82,43,76,6,88,1.83559663099913,,0.2,90,82,76,-8,-14
4,1,57,10,3,-7,83,82,82,1,98,1.53421251600048,,0.2,90,83,82,-7,-8
4,1,58,6,1,0,0,95,179,1,98,3.77764514699993,,0.2,0,0,-1,0,-1
4,1,59,3,3,-3,87,56,83,4,92,2.2607390510002,,0.2,90,87,83,-3,-7
4,1,60,6,1,5,5,54,2,3,94,2.53503895699941,,0.2,0,5,2,5,2
4,1,61,2,4,5,140,83,154,-14,72,3.0147614919988,,0.2,135,140,154,5,19
4,1,62,10,2,8,53,77,45,8,84,2.76868560000003,,0.2,45,53,45,8,0
4,1,63,8,1,-5,175,80,165,10,80,3.0745650480003,,0.2,0,-5,-15,-5,-15
4,1,64,7,1,-2,178,18,179,-1,98,1.77486535999924,,0.2,0,-2,-1,-2,-1
4,1,65,5,2,2,47,65,37,10,80,1.90585457400084,,0.2,45,47,37,2,-8
4,1,66,4,3,-1,89,152,89,0,100,3.29309088500122,,0.2,90,89,89,-1,-1
4,1,67,2,3,8,98,126,100,-2,96,2.00943250400087,,0.2,90,98,100,8,10
4,1,68,8,4,6,141,44,121,20,60,2.82972084399989,,0.2,135,141,121,6,-14
4,1,69,5,2,7,52,80,59,-7,86,2.61000472200067,,0.2,45,52,59,7,14
4,1,70,6,4,-10,125,100,117,8,84,1.53266580399941,,0.2,135,125,117,-10,-18
4,1,71,4,2,4,49,25,49,0,100,2.39622506199885,,0.2,45,49,49,4,4
4,1,72,10,4,1,136,9,147,-11,78,2.58255303300029,,0.2,135,136,147,1,12
4,1,73,4,4,-6,129,151,132,-3,94,2.46118087799914,,0.2,135,129,132,-6,-3
4,1,74,5,4,-9,126,80,124,2,96,2.84761963399978,,0.2,135,126,124,-9,-11
4,1,75,5,1,-9,171,146,173,-2,96,1.90614117400037,,0.2,0,-9,-7,-9,-7
4,1,76,10,2,-4,41,137,54,-13,74,4.09914345499965,,0.2,45,41,54,-4,9
4,1,77,10,1,-4,176,107,179,-3,94,3.00614320800014,,0.2,0,-4,-1,-4,-1
4,1,78,3,2,-7,38,53,36,2,96,1.52917072300079,,0.2,45,38,36,-7,-9
4,1,80,1,3,-7,83,15,79,4,92,3.15587277799932,,0.2,90,83,79,-7,-11
4,1,81,2,1,-5,175,37,174,1,98,2.02139569199971,,0.2,0,-5,-6,-5,-6
4,1,82,8,1,0,0,125,178,2,96,3.07662630599953,,0.2,0,0,-2,0,-2
4,1,83,8,2,-7,38,89,25,13,74,2.4044787519997,,0.2,45,38,25,-7,-20
4,1,84,10,4,10,145,42,156,-11,78,2.62503619900053,,0.2,135,145,156,10,21
4,1,85,1,1,6,6,1,6,0,100,1.49547159299982,,0.2,0,6,6,6,6
4,1,86,9,4,4,139,154,150,-11,78,1.60288718599986,,0.2,135,139,150,4,15
4,1,87,9,1,-4,176,30,172,4,92,2.06064263400003,,0.2,0,-4,-8,-4,-8
4,1,88,1,2,-6,39,69,31,8,84,1.68770587699873,,0.2,45,39,31,-6,-14
4,1,89,4,2,3,48,83,40,8,84,2.06785065099939,,0.2,45,48,40,3,-5
4,1,90,7,1,0,0,39,179,1,98,1.64960910300033,,0.2,0,0,-1,0,-1
4,1,91,4,4,3,138,22,148,-10,80,2.02612334599871,,0.2,135,138,148,3,13
4,1,92,1,3,10,100,60,104,-4,92,2.43380379100017,,0.2,90,100,104,10,14
4,1,93,9,3,1,91,10,88,3,94,3.57271388400113,,0.2,90,91,88,1,-2
4,1,94,4,1,2,2,58,3,-1,98,3.1460889480004,,0.2,0,2,3,2,3
4,1,95,9,2,10,55,105,46,9,82,2.16523615699953,,0.2,45,55,46,10,1
4,1,96,3,4,-2,133,97,133,0,100,1.68162387499979,,0.2,135,133,133,-2,-2
4,1,97,6,3,-5,85,179,79,6,88,3.41443615599928,,0.2,90,85,79,-5,-11
4,1,98,6,3,-4,86,169,79,7,86,3.07048127000053,,0.2,90,86,79,-4,-11
4,1,99,8,4,3,138,9,126,12,76,3.82022601999961,,0.2,135,138,126,3,-9
4,1,100,10,4,9,144,91,135,9,82,2.02826181000091,,0.2,135,144,135,9,0
4,1,101,7,2,-5,40,180,42,-2,96,2.070533256001,,0.2,45,40,42,-5,-3
4,1,102,7,3,2,92,43,101,-9,82,1.99499998200008,,0.2,90,92,101,2,11
4,1,103,8,2,-2,43,1,41,2,96,1.82699306100039,,0.2,45,43,41,-2,-4
4,1,104,2,3,-9,81,76,76,5,90,1.04520295899965,,0.2,90,81,76,-9,-14
4,1,105,3,1,3,3,96,4,-1,98,3.64054965799914,,0.2,0,3,4,3,4
4,1,106,6,2,-4,41,75,41,0,100,1.51500123900041,,0.2,45,41,41,-4,-4
4,1,107,7,4,-10,125,58,130,-5,90,2.44299378200049,,0.2,135,125,130,-10,-5
4,1,108,2,2,8,53,172,49,4,92,2.147553023,,0.2,45,53,49,8,4
4,1,109,5,4,-4,131,117,137,-6,88,1.08998178699949,,0.2,135,131,137,-4,2
4,1,110,9,4,-4,131,131,133,-2,96,0.983725084999605,,0.2,135,131,133,-4,-2
4,1,111,1,4,-9,126,55,144,-18,64,2.96511741799986,,0.2,135,126,144,-9,9
4,1,112,3,3,4,94,22,104,-10,80,2.8191204729992,,0.2,90,94,104,4,14
4,1,113,6,2,6,51,174,73,-22,56,2.51352616999975,,0.2,45,51,73,6,28
4,1,114,4,4,-6,129,104,137,-8,84,1.49230985099894,,0.2,135,129,137,-6,2
4,1,115,3,1,-8,172,52,154,18,64,3.49814045099993,,0.2,0,-8,-26,-8,-26
4,1,116,1,1,-4,176,33,173,3,94,1.98165655000048,,0.2,0,-4,-7,-4,-7
4,1,117,4,1,8,8,176,13,-5,90,1.05550836899965,,0.2,0,8,13,8,13
4,1,118,10,1,8,8,104,15,-7,86,3.03664623999975,,0.2,0,8,15,8,15
4,1,119,8,3,-5,85,50,82,3,94,1.40424132000044,,0.2,90,85,82,-5,-8
4,1,120,1,3,9,99,141,101,-2,96,2.74412388600103,,0.2,90,99,101,9,11
4,1,121,2,3,-9,81,80,82,-1,98,1.01922487900083,,0.2,90,81,82,-9,-8
4,1,122,2,1,8,8,60,4,4,92,2.85660351300066,,0.2,0,8,4,8,4
4,1,123,6,2,0,45,164,41,4,92,2.17666788799943,,0.2,45,45,41,0,-4
4,1,124,7,2,7,52,56,53,-1,98,0.936748052001349,,0.2,45,52,53,7,8
4,1,125,6,2,4,49,166,50,-1,98,2.37826253800085,,0.2,45,49,50,4,5
4,1,126,4,1,9,9,55,17,-8,84,1.81669821400101,,0.2,0,9,17,9,17
4,1,127,10,2,-7,38,174,45,-7,86,1.88125316900005,,0.2,45,38,45,-7,0
4,1,128,9,1,-1,179,136,1,-2,96,1.76177059000111,,0.2,0,-1,1,-1,1
4,1,129,8,4,4,139,152,142,-3,94,1.03009975999885,,0.2,135,139,142,4,7
4,1,130,9,4,-2,133,81,119,14,72,1.73477136499969,,0.2,135,133,119,-2,-16
4,1,131,7,4,-4,131,107,132,-1,98,1.64978614799838,,0.2,135,131,132,-4,-3
4,1,132,3,2,3,48,147,42,6,88,3.10435793299985,,0.2,45,48,42,3,-3
4,1,133,6,4,-8,127,122,128,-1,98,1.19518306899954,,0.2,135,127,128,-8,-7
4,1,134,10,3,7,97,139,112,-15,70,1.84137091899902,,0.2,90,97,112,7,22
4,1,135,6,3,-3,87,112,88,-1,98,2.33687561400075,,0.2,90,87,88,-3,-2
4,1,136,6,4,0,135,30,123,12,76,4.08767364300002,,0.2,135,135,123,0,-12
4,1,137,7,3,0,90,147,91,-1,98,3.22434071399948,,0.2,90,90,91,0,1
4,1,138,3,2,7,52,85,59,-7,86,1.66144897400045,,0.2,45,52,59,7,14
4,1,139,3,4,1,136,167,126,10,80,1.74274984000112,,0.2,135,136,126,1,-9
4,1,140,1,4,7,142,35,137,5,90,2.614055293001,,0.2,135,142,137,7,2
4,1,141,8,1,5,5,83,173,12,76,3.17346811599964,,0.2,0,5,-7,5,-7
4,1,142,3,3,-5,85,66,87,-2,96,2.90745073399921,,0.2,90,85,87,-5,-3
4,1,143,1,2,3,48,33,49,-1,98,1.5801265909995,,0.2,45,48,49,3,4
4,1,144,5,1,-8,172,35,167,5,90,1.66691282600004,,0.2,0,-8,-13,-8,-13
4,1,145,5,1,2,2,20,7,-5,90,1.65803669900015,,0.2,0,2,7,2,7
4,1,146,3,3,6,96,54,94,2,96,2.50677007100057,,0.2,90,96,94,6,4
4,1,147,8,1,-10,170,149,176,-6,88,2.02725583699976,,0.2,0,-10,-4,-10,-4
4,1,148,2,4,5,140,179,151,-11,78,1.57327382599942,,0.2,135,140,151,5,16
4,1,149,9,2,1,46,126,65,-19,62,2.82344902799923,,0.2,45,46,65,1,20
4,1,150,10,1,-2,178,36,176,2,96,2.67091878099927,,0.2,0,-2,-4,-2,-4
4,1,151,7,3,9,99,99,99,0,100,1.10997748199952,,0.2,90,99,99,9,9
4,1,152,6,3,-1,89,36,85,4,92,3.23301528500087,,0.2,90,89,85,-1,-5
4,1,153,10,3,-4,86,104,82,4,92,1.88575716499872,,0.2,90,86,82,-4,-8
4,1,154,2,2,-8,37,153,59,-22,56,3.24250400700112,,0.2,45,37,59,-8,14
4,1,155,4,4,1,136,134,131,5,90,1.13307006200012,,0.2,135,136,131,1,-4
4,1,156,8,3,-8,82,119,75,7,86,2.38096455599953,,0.2,90,82,75,-8,-15
4,1,157,9,3,-2,88,147,88,0,100,2.80735567299962,,0.2,90,88,88,-2,-2
4,1,159,1,1,5,5,20,9,-4,92,1.55564470299942,,0.2,0,5,9,5,9
4,1,160,2,1,2,2,178,6,-4,92,1.10689204499977,,0.2,0,2,6,2,6
5,1,1,4,4,-5,130,137,132,-2,96,2.20751712799392,,0.2,135,130,132,-5,-3
5,1,3,6,3,9,99,128,99,0,100,2.89393668399862,,0.2,90,99,99,9,9
5,1,4,5,2,2,47,51,51,-4,92,1.22903897100332,,0.2,45,47,51,2,6
5,1,5,9,3,-8,82,152,79,3,94,3.14952978599467,,0.2,90,82,79,-8,-11
5,1,6,3,1,-5,175,58,174,1,98,2.66932564799936,,0.2,0,-5,-6,-5,-6
5,1,7,9,1,-9,171,43,177,-6,88,2.19825000299898,,0.2,0,-9,-3,-9,-3
5,1,8,3,1,-5,175,143,173,2,96,2.35788108799898,,0.2,0,-5,-7,-5,-7
5,1,9,7,1,-8,172,120,169,3,94,2.50838211899827,,0.2,0,-8,-11,-8,-11
5,1,10,4,2,-6,39,27,38,1,98,1.10073156300496,,0.2,45,39,38,-6,-7
5,1,11,5,3,-5,85,175,70,15,70,4.32459991799988,,0.2,90,85,70,-5,-20
5,1,12,7,2,-6,39,52,38,1,98,1.35825408800156,,0.2,45,39,38,-6,-7
5,1,13,5,3,-7,83,26,78,5,90,3.99318509500154,,0.2,90,83,78,-7,-12
5,1,14,5,1,4,4,3,10,-6,88,0.972826393001014,,0.2,0,4,10,4,10
5,1,15,2,4,5,140,28,145,-5,90,3.01377724699705,,0.2,135,140,145,5,10
5,1,16,10,1,-2,178,139,161,17,66,1.45749916199566,,0.2,0,-2,-19,-2,-19
5,1,17,6,2,-7,38,111,35,3,94,3.62448960899928,,0.2,45,38,35,-7,-10
5,1,18,1,2,-1,44,125,45,-1,98,3.53394094299438,,0.2,45,44,45,-1,0
5,1,19,3,3,-10,80,53,75,5,90,1.38550607999787,,0.2,90,80,75,-10,-15
5,1,20,3,2,-3,42,146,38,4,92,2.81330843599426,,0.2,45,42,38,-3,-7
5,1,21,2,1,3,3,45,11,-8,84,1.60999416499544,,0.2,0,3,11,3,11
5,1,22,3,2,-1,44,133,47,-3,94,2.93323133599915,,0.2,45,44,47,-1,2
5,1,23,8,3,4,94,17,102,-8,84,2.78128957599984,,0.2,90,94,102,4,12
5,1,24,4,3,3,93,91,98,-5,90,0.938182723999489,,0.2,90,93,98,3,8
5,1,25,8,4,-4,131,1,139,-8,84,1.90445792300306,,0.2,135,131,139,-4,4
5,1,26,4,1,7,7,0,9,-2,96,1.24728411300021,,0.2,0,7,9,7,9
5,1,27,1,4,1,136,26,142,-6,88,2.32697808800003,,0.2,135,136,142,1,7
5,1,28,6,4,-2,133,108,129,4,92,1.67390871099633,,0.2,135,133,129,-2,-6
5,1,29,7,3,-4,86,76,83,3,94,0.96072221200302,,0.2,90,86,83,-4,-7
5,1,30,10,2,-3,42,158,35,7,86,2.96191472100327,,0.2,45,42,35,-3,-10
5,1,31,9,4,7,142,82,126,16,68,2.30452144800074,,0.2,135,142,126,7,-9
5,1,32,6,4,5,140,153,147,-7,86,1.28613507999398,,0.2,135,140,147,5,12
5,1,33,6,1,1,1,111,3,-2,96,3.28483259499626,,0.2,0,1,3,1,3
5,1,34,4,4,5,140,123,123,17,66,0.872502846999851,,0.2,135,140,123,5,-12
5,1,35,2,3,-5,85,91,78,7,86,1.44832200399833,,0.2,90,85,78,-5,-12
5,1,36,2,1,-5,175,129,173,2,96,2.09330582399707,,0.2,0,-5,-7,-5,-7
5,1,37,9,2,-7,38,119,42,-4,92,3.09160967599746,,0.2,45,38,42,-7,-3
5,1,38,9,2,8,53,131,49,4,92,3.19791514099779,,0.2,45,53,49,8,4
5,1,39,2,3,-8,82,99,70,12,76,1.42609203200118,,0.2,90,82,70,-8,-20
5,1,40,8,1,1,1,102,3,-2,96,2.60011432499596,,0.2,0,1,3,1,3
5,1,41,10,4,4,139,29,148,-9,82,2.21307814399916,,0.2,135,139,148,4,13
5,1,42,10,1,8,8,77,24,-16,68,2.49063962200307,,0.2,0,8,24,8,24
5,1,43,5,1,8,8,92,15,-7,86,2.82122950499615,,0.2,0,8,15,8,15
5,1,44,2,4,6,141,176,142,-1,98,2.01174192700273,,0.2,135,141,142,6,7
5,1,45,7,2,-1,44,87,61,-17,66,1.77709018099995,,0.2,45,44,61,-1,16
5,1,46,5,1,4,4,8,11,-7,86,1.09881329199561,,0.2,0,4,11,4,11
5,1,47,9,3,6,96,125,103,-7,86,2.21328183500009,,0.2,90,96,103,6,13
5,1,48,8,3,-7,83,133,83,0,100,2.38810624599864,,0.2,90,83,83,-7,-7
5,1,49,1,1,4,4,88,11,-7,86,2.87596175100043,,0.2,0,4,11,4,11
5,1,50,10,3,-2,88,122,83,5,90,1.96004490600171,,0.2,90,88,83,-2,-7
5,1,51,10,3,10,100,19,100,0,100,3.12717190300464,,0.2,90,100,100,10,10
5,1,52,5,3,1,91,37,91,0,100,2.92597356899932,,0.2,90,91,91,1,1
5,1,53,3,1,2,2,3,4,-2,96,1.90085227700183,,0.2,0,2,4,2,4
5,1,54,3,1,-7,173,64,171,2,96,3.29872347100172,,0.2,0,-7,-9,-7,-9
5,1,55,3,3,3,93,162,95,-2,96,3.15044956900238,,0.2,90,93,95,3,5
5,1,56,8,3,2,92,49,90,2,96,4.038371749004,,0.2,90,92,90,2,0
5,1,58,9,4,-5,130,47,120,10,80,2.55390016699675,,0.2,135,130,120,-5,-15
5,1,59,8,4,-2,133,80,124,9,82,1.91816101499717,,0.2,135,133,124,-2,-11
5,1,60,7,2,-8,37,68,43,-6,88,1.52999155500584,,0.2,45,37,43,-8,-2
5,1,61,4,2,1,46,148,41,5,90,2.72712824000337,,0.2,45,46,41,1,-4
5,1,62,3,3,8,98,47,108,-10,80,2.5057905729991,,0.2,90,98,108,8,18
5,1,63,1,3,2,92,152,99,-7,86,2.4228535220027,,0.2,90,92,99,2,9
5,1,64,6,3,-2,88,164,82,6,88,3.21899065900652,,0.2,90,88,82,-2,-8
5,1,65,7,4,0,135,101,130,5,90,1.4990881929989,,0.2,135,135,130,0,-5
5,1,66,5,2,6,51,170,35,16,68,2.01465627099969,,0.2,45,51,35,6,-10
5,1,67,6,3,1,91,23,94,-3,94,2.51598193000245,,0.2,90,91,94,1,4
5,1,68,7,1,2,2,71,9,-7,86,2.56415285300318,,0.2,0,2,9,2,9
5,1,69,4,3,0,90,176,84,6,88,3.4504685819993,,0.2,90,90,84,0,-6
5,1,70,9,3,-6,84,128,85,-1,98,1.66322161000426,,0.2,90,84,85,-6,-5
5,1,71,10,3,0,90,26,85,5,90,2.45137142399471,,0.2,90,90,85,0,-5
5,1,72,4,2,3,48,88,52,-4,92,1.50853633600491,,0.2,45,48,52,3,7
5,1,73,2,4,1,136,125,129,7,86,0.950900726995314,,0.2,135,136,129,1,-6
5,1,74,1,1,5,5,85,8,-3,94,3.43445825199888,,0.2,0,5,8,5,8
5,1,75,4,4,-5,130,135,130,0,100,0.891709764997358,,0.2,135,130,130,-5,-5
5,1,76,6,3,-8,82,33,78,4,92,1.8639889479964,,0.2,90,82,78,-8,-12
5,1,77,10,4,-1,134,44,131,3,94,3.13446653700521,,0.2,135,134,131,-1,-4
5,1,78,6,1,-4,176,4,170,6,88,1.57689160500013,,0.2,0,-4,-10,-4,-10
5,1,79,6,4,-3,132,167,133,-1,98,1.95795291700051,,0.2,135,132,133,-3,-2
5,1,80,8,1,-2,178,21,171,7,86,1.48815304799791,,0.2,0,-2,-9,-2,-9
5,1,81,8,2,-9,36,12,34,2,96,1.85470363700006,,0.2,45,36,34,-9,-11
5,1,82,6,2,-6,39,88,53,-14,72,1.98700990300131,,0.2,45,39,53,-6,8
5,1,83,2,1,4,4,119,13,-9,82,3.05128266700194,,0.2,0,4,13,4,13
5,1,84,8,3,-6,84,121,77,7,86,2.04842726000061,,0.2,90,84,77,-6,-13
5,1,85,9,4,-1,134,30,133,1,98,3.37619439499395,,0.2,135,134,133,-1,-2
5,1,86,8,4,-5,130,118,127,3,94,1.01155416500114,,0.2,135,130,127,-5,-8
5,1,87,4,1,7,7,114,10,-3,94,2.8718074960052,,0.2,0,7,10,7,10
5,1,88,10,2,2,47,151,45,2,96,2.40696863899939,,0.2,45,47,45,2,0
5,1,89,5,4,3,138,61,140,-2,96,3.42582458400284,,0.2,135,138,140,3,5
5,1,90,4,3,9,99,73,109,-10,80,1.68667567499506,,0.2,90,99,109,9,19
5,1,91,6,1,1,1,39,2,-1,98,1.62435107500642,,0.2,0,1,2,1,2
5,1,92,1,1,5,5,117,6,-1,98,2.48912765899877,,0.2,0,5,6,5,6
5,1,93,6,4,9,144,99,135,9,82,2.10806142799993,,0.2,135,144,135,9,0
5,1,94,4,1,5,5,83,10,-5,90,3.59514525599661,,0.2,0,5,10,5,10
5,1,95,3,2,-2,43,176,47,-4,92,1.82451010400109,,0.2,45,43,47,-2,2
5,1,96,6,2,-9,36,124,47,-11,78,3.35198408799624,,0.2,45,36,47,-9,2
5,1,97,5,4,7,142,10,147,-5,90,1.89715556900046,,0.2,135,142,147,7,12
5,1,98,4,2,5,50,62,54,-4,92,1.33945809899888,,0.2,45,50,54,5,9
5,1,99,2,2,-10,35,95,52,-17,66,2.176023592001,,0.2,45,35,52,-10,7
5,1,100,8,4,-4,131,40,132,-1,98,2.9720006589996,,0.2,135,131,132,-4,-3
5,1,101,5,2,9,54,143,43,11,78,2.65206365499762,,0.2,45,54,43,9,-2
5,1,102,5,1,-7,173,24,170,3,94,1.56867519099615,,0.2,0,-7,-10,-7,-10
5,1,103,8,2,2,47,131,39,8,84,2.59232775300188,,0.2,45,47,39,2,-6
5,1,104,7,1,5,5,126,8,-3,94,2.26619719199516,,0.2,0,5,8,5,8
5,1,105,1,2,-9,36,160,31,5,90,2.17608430600376,,0.2,45,36,31,-9,-14
5,1,106,1,3,0,90,162,84,6,88,2.96897934099979,,0.2,90,90,84,0,-6
5,1,107,8,2,-4,41,22,39,2,96,1.35709767299704,,0.2,45,41,39,-4,-6
5,1,108,1,1,8,8,95,14,-6,88,2.96900365599868,,0.2,0,8,14,8,14
5,1,109,5,4,9,144,43,134,10,80,3.42425590100174,,0.2,135,144,134,9,-1
5,1,110,3,4,-9,126,80,116,10,80,1.89150654900004,,0.2,135,126,116,-9,-19
5,1,111,2,3,1,91,76,90,1,98,2.46299584000371,,0.2,90,91,90,1,0
5,1,112,9,1,-6,174,58,167,7,86,2.48210756500339,,0.2,0,-6,-13,-6,-13
5,1,113,4,3,-7,83,62,83,0,100,1.70906369500153,,0.2,90,83,83,-7,-7
5,1,114,5,3,1,91,52,91,0,100,2.4092963869989,,0.2,90,91,91,1,1
5,1,115,2,4,-6,129,100,127,2,96,1.40801971199835,,0.2,135,129,127,-6,-8
5,1,116,1,2,6,51,148,41,10,80,3.03950462100329,,0.2,45,51,41,6,-4
5,1,117,3,2,3,48,150,45,3,94,2.55031493300339,,0.2,45,48,45,3,0
5,1,118,3,4,0,135,120,131,4,92,1.00575696099986,,0.2,135,135,131,0,-4
5,1,119,3,4,-5,130,3,140,-10,80,2.26864499600197,,0.2,135,130,140,-5,5
5,1,120,10,1,-5,175,44,169,6,88,2.17079253699922,,0.2,0,-5,-11,-5,-11
5,1,121,7,3,8,98,53,106,-8,84,2.16012359599699,,0.2,90,98,106,8,16
5,1,122,9,1,-5,175,18,168,7,86,1.39216034599667,,0.2,0,-5,-12,-5,-12
5,1,123,7,2,10,55,44,44,11,78,1.99718509399827,,0.2,45,55,44,10,-1
5,1,124,7,3,3,93,142,86,7,86,2.24347447499895,,0.2,90,93,86,3,-4
5,1,125,8,1,9,9,175,12,-3,94,1.4263407460021,,0.2,0,9,12,9,12
5,1,126,5,4,4,139,173,144,-5,90,1.54087422900193,,0.2,135,139,144,4,9
5,1,127,5,2,-6,39,123,50,-11,78,3.42181223100488,,0.2,45,39,50,-6,5
5,1,128,1,2,3,48,45,43,5,90,1.13712197299901,,0.2,45,48,43,3,-2
5,1,129,9,2,8,53,96,61,-8,84,1.69877532600367,,0.2,45,53,61,8,16
5,1,130,2,2,9,54,64,58,-4,92,0.722331188997487,,0.2,45,54,58,9,13
5,1,131,9,1,1,1,127,2,-1,98,1.99667892499565,,0.2,0,1,2,1,2
5,1,132,7,4,1,136,21,145,-9,82,2.0819419709951,,0.2,135,136,145,1,10
5,1,133,7,4,-5,130,32,142,-12,76,2.62815539300209,,0.2,135,130,142,-5,7
5,1,134,2,2,3,48,157,49,-1,98,2.51196327799698,,0.2,45,48,49,3,4
5,1,135,8,2,8,53,14,49,4,92,1.52190556500136,,0.2,45,53,49,8,4
5,1,136,1,4,-2,133,122,133,0,100,1.12615273200208,,0.2,135,133,133,-2,-2
5,1,137,7,1,10,10,152,7,3,94,1.7600496849991,,0.2,0,10,7,10,7
5,1,138,2,1,9,9,17,12,-3,94,1.09695428599662,,0.2,0,9,12,9,12
5,1,139,4,1,-1,179,47,4,-5,90,2.16716197399364,,0.2,0,-1,4,-1,4
5,1,140,1,3,-2,88,137,80,8,84,2.20764879199851,,0.2,90,88,80,-2,-10
5,1,141,8,1,-7,173,122,170,3,94,2.20167513100023,,0.2,0,-7,-10,-7,-10
5,1,142,4,4,0,135,145,150,-15,70,1.24594696400163,,0.2,135,135,150,0,15
5,1,143,9,3,-9,81,72,79,2,96,1.31285417400068,,0.2,90,81,79,-9,-11
5,1,144,2,3,-8,82,158,74,8,84,2.70545049700013,,0.2,90,82,74,-8,-16
5,1,145,10,1,4,4,48,12,-8,84,2.31182776299829,,0.2,0,4,12,4,12
5,1,146,7,3,8,98,32,101,-3,94,2.40016452100099,,0.2,90,98,101,8,11
5,1,147,6,2,7,52,48,48,4,92,0.61239738400036,,0.2,45,52,48,7,3
5,1,148,10,3,0,90,178,90,0,100,3.05071261999547,,0.2,90,90,90,0,0
5,1,149,3,3,-10,80,162,74,6,88,2.77049945600447,,0.2,90,80,74,-10,-16
5,1,150,7,4,0,135,135,135,0,100,0.875478792004287,,0.2,135,135,135,0,0
5,1,151,10,4,7,142,61,145,-3,94,3.14623892900272,,0.2,135,142,145,7,10
5,1,152,9,4,-5,130,156,136,-6,88,1.4775928060044,,0.2,135,130,136,-5,1
5,1,153,9,2,-7,38,129,42,-4,92,3.13510691499687,,0.2,45,38,42,-7,-3
5,1,154,6,1,8,8,130,13,-5,90,2.26354977199662,,0.2,0,8,13,8,13
5,1,155,1,4,6,141,83,144,-3,94,2.92071443999885,,0.2,135,141,144,6,9
5,1,156,3,4,6,141,127,130,11,78,0.782260631000099,,0.2,135,141,130,6,-5
5,1,157,10,2,5,50,14,44,6,88,1.44198238699755,,0.2,45,50,44,5,-1
5,1,158,1,3,-8,82,15,67,15,70,2.04769274099817,,0.2,90,82,67,-8,-23
5,1,159,2,2,1,46,32,44,2,96,1.1170635219969,,0.2,45,46,44,1,-1
5,1,160,10,4,1,136,95,127,9,82,1.49626592800632,,0.2,135,136,127,1,-8
6,1,1,9,1,-6,174,25,173,1,98,2.27251669997349,,0.2,0,-6,-7,-6,-7
6,1,2,7,3,2,92,6,91,1,98,4.07843360002153,,0.2,90,92,91,2,1
6,1,3,6,1,-5,175,112,173,2,96,2.4116324998904,,0.2,0,-5,-7,-5,-7
6,1,4,4,2,8,53,109,62,-9,82,1.87237249989994,,0.2,45,53,62,8,17
6,1,5,10,2,9,54,51,52,2,96,1.63708909996785,,0.2,45,54,52,9,7
6,1,6,3,1,6,6,141,5,1,98,2.14586910000071,,0.2,0,6,5,6,5
6,1,7,3,4,4,139,55,147,-8,84,3.83615220012143,,0.2,135,139,147,4,12
6,1,8,9,1,-4,176,57,176,0,100,3.93284210003912,,0.2,0,-4,-4,-4,-4
6,1,9,10,4,1,136,38,136,0,100,3.17563860001974,,0.2,135,136,136,1,1
6,1,10,4,2,-6,39,51,45,-6,88,1.66660349979065,,0.2,45,39,45,-6,0
6,1,11,5,2,2,47,26,39,8,84,1.9815527999308,,0.2,45,47,39,2,-6
6,1,12,10,4,1,136,73,137,-1,98,4.01755099999718,,0.2,135,136,137,1,2
6,1,13,9,2,-9,36,152,32,4,92,3.01171320001595,,0.2,45,36,32,-9,-13
6,1,14,6,1,-2,178,130,179,-1,98,2.14552189991809,,0.2,0,-2,-1,-2,-1
6,1,15,6,4,-5,130,36,138,-8,84,1.70323310000822,,0.2,135,130,138,-5,3
6,1,16,10,1,9,9,77,2,7,86,3.5509361999575,,0.2,0,9,2,9,2
6,1,17,2,4,9,144,98,136,8,84,1.88467799988575,,0.2,135,144,136,9,1
6,1,18,8,4,0,135,82,132,3,94,2.35142640001141,,0.2,135,135,132,0,-3
6,1,19,9,3,-6,84,67,84,0,100,3.70835050009191,,0.2,90,84,84,-6,-6
6,1,20,1,3,6,96,72,95,1,98,2.25996029982343,,0.2,90,96,95,6,5
6,1,21,10,1,5,5,0,0,5,90,1.40576340002008,,0.2,0,5,0,5,0
6,1,22,8,2,-4,41,89,50,-9,82,2.16348019987345,,0.2,45,41,50,-4,5
6,1,23,3,1,5,5,122,3,2,96,2.21805250016041,,0.2,0,5,3,5,3
6,1,24,10,2,2,47,14,36,11,78,2.2117049000226,,0.2,45,47,36,2,-9
6,1,25,6,4,1,136,92,129,7,86,2.22963419998996,,0.2,135,136,129,1,-6
6,1,26,7,4,-4,131,148,129,2,96,1.75150070013478,,0.2,135,131,129,-4,-6
6,1,27,8,2,2,47,54,46,1,98,2.85456320014782,,0.2,45,47,46,2,1
6,1,28,10,2,8,53,176,46,7,86,2.61794620007277,,0.2,45,53,46,8,1
6,1,29,6,2,3,48,41,47,1,98,1.16932419990189,,0.2,45,48,47,3,2
6,1,30,1,2,7,52,143,49,3,94,2.56923969998024,,0.2,45,52,49,7,4
6,1,31,1,3,9,99,72,100,-1,98,2.32708760001697,,0.2,90,99,100,9,10
6,1,32,1,4,9,144,111,144,0,100,1.88475399999879,,0.2,135,144,144,9,9
6,1,34,6,4,-5,130,112,135,-5,90,2.76979589997791,,0.2,135,130,135,-5,0
6,1,35,1,1,-2,178,71,177,1,98,3.98727759998292,,0.2,0,-2,-3,-2,-3
6,1,36,1,2,2,47,58,45,2,96,2.06031140009873,,0.2,45,47,45,2,0
6,1,37,8,2,-7,38,32,31,7,86,2.67253310000524,,0.2,45,38,31,-7,-14
6,1,38,9,4,-8,127,50,131,-4,92,2.58133689989336,,0.2,135,127,131,-8,-4
6,1,39,3,3,1,91,107,96,-5,90,3.56309129996225,,0.2,90,91,96,1,6
6,1,40,3,4,-10,125,14,121,4,92,2.18178039998747,,0.2,135,125,121,-10,-14
6,1,41,5,2,-2,43,102,53,-10,80,1.4116636000108,,0.2,45,43,53,-2,8
6,1,42,6,4,-3,132,151,131,1,98,1.35711889993399,,0.2,135,132,131,-3,-4
6,1,43,7,1,2,2,130,6,-4,92,3.51464880001731,,0.2,0,2,6,2,6
6,1,44,3,2,4,49,31,45,4,92,1.40575439995155,,0.2,45,49,45,4,0
6,1,46,5,3,4,94,68,93,1,98,1.58151610009372,,0.2,90,94,93,4,3
6,1,47,2,1,-9,171,98,177,-6,88,3.36928990017623,,0.2,0,-9,-3,-9,-3
6,1,48,1,3,1,91,31,94,-3,94,3.00553250010125,,0.2,90,91,94,1,4
6,1,49,5,2,-6,39,106,32,7,86,1.7208356000483,,0.2,45,39,32,-6,-13
6,1,50,4,2,-5,40,160,32,8,84,2.29092899989337,,0.2,45,40,32,-5,-13
6,1,51,8,3,7,97,138,96,1,98,2.23462240002118,,0.2,90,97,96,7,6
6,1,52,7,4,-8,127,79,112,15,70,1.76988620008342,,0.2,135,127,112,-8,-23
6,1,53,6,1,7,7,135,12,-5,90,2.89104689983651,,0.2,0,7,12,7,12
6,1,54,4,4,9,144,146,146,-2,96,1.88464489998296,,0.2,135,144,146,9,11
6,1,55,3,4,3,138,137,137,1,98,1.18154999986291,,0.2,135,138,137,3,2
6,1,56,8,4,-7,128,162,130,-2,96,2.2419628999196,,0.2,135,128,130,-7,-5
6,1,57,9,1,-5,175,9,172,3,94,3.09653980005533,,0.2,0,-5,-8,-5,-8
6,1,58,9,3,6,96,137,98,-2,96,2.56926409993321,,0.2,90,96,98,6,8
6,1,59,8,4,-6,129,8,129,0,100,2.89651390002109,,0.2,135,129,129,-6,-6
6,1,60,3,3,-9,81,154,81,0,100,2.24225570005365,,0.2,90,81,81,-9,-9
6,1,63,7,4,5,140,38,142,-2,96,2.21863420004956,,0.2,135,140,142,5,7
6,1,64,1,4,-5,130,60,129,1,98,2.56356799998321,,0.2,135,130,129,-5,-6
6,1,65,5,2,5,50,129,50,0,100,3.99958730000071,,0.2,45,50,50,5,5
6,1,67,2,2,3,48,19,39,9,82,1.92686550016515,,0.2,45,48,39,3,-6
6,1,68,5,4,4,139,69,128,11,78,2.18170840013772,,0.2,135,139,128,4,-7
6,1,69,7,1,-4,176,136,175,1,98,3.12078419979662,,0.2,0,-4,-5,-4,-5
6,1,71,5,1,-8,172,172,172,0,100,0.878842300036922,,0.2,0,-8,-8,-8,-8
6,1,72,10,3,-5,85,76,82,3,94,1.66064039990306,,0.2,90,85,82,-5,-8
6,1,73,5,3,8,98,94,94,4,92,0.963448400143534,,0.2,90,98,94,8,4
6,1,74,4,3,4,94,154,95,-1,98,3.11454790015705,,0.2,90,94,95,4,5
6,1,75,9,3,7,97,39,95,2,96,1.64846589998342,,0.2,90,97,95,7,5
6,1,76,4,3,2,92,88,90,2,96,3.55098540009931,,0.2,90,92,90,2,0
6,1,77,10,3,7,97,153,93,4,92,2.97541630011983,,0.2,90,97,93,7,3
6,1,78,10,1,-9,171,74,173,-2,96,3.34521970013157,,0.2,0,-9,-7,-9,-7
6,1,79,9,4,4,139,51,133,6,88,2.58139800000936,,0.2,135,139,133,4,-2
6,1,80,7,2,1,46,7,43,3,94,2.45376009983011,,0.2,45,46,43,1,-2
6,1,81,10,1,-8,172,47,170,2,96,2.2479095000308,,0.2,0,-8,-10,-8,-10
6,1,82,10,3,-6,84,171,85,-1,98,4.42370310006663,,0.2,90,84,85,-6,-5
6,1,83,5,4,10,145,19,149,-4,92,2.1266296999529,,0.2,135,145,149,10,14
6,1,84,6,1,-9,171,18,170,1,98,1.84811190003529,,0.2,0,-9,-10,-9,-10
6,1,85,8,1,-9,171,176,170,1,98,1.79392080008984,,0.2,0,-9,-10,-9,-10
6,1,86,6,3,1,91,177,88,3,94,3.41160430014133,,0.2,90,91,88,1,-2
6,1,87,10,4,-3,132,66,129,3,94,1.62380250007845,,0.2,135,132,129,-3,-6
6,1,88,2,1,-5,175,48,173,2,96,1.89681780012324,,0.2,0,-5,-7,-5,-7
6,1,89,9,3,5,95,142,94,1,98,1.81802890007384,,0.2,90,95,94,5,4
6,1,90,9,4,0,135,121,136,-1,98,1.81175009999424,,0.2,135,135,136,0,1
6,1,91,9,2,-3,42,9,39,3,94,2.14534100005403,,0.2,45,42,39,-3,-6
6,1,92,7,1,-9,171,129,170,1,98,2.10308629996143,,0.2,0,-9,-10,-9,-10
6,1,93,1,4,6,141,123,145,-4,92,1.90282800002024,,0.2,135,141,145,6,10
6,1,94,9,4,1,136,87,133,3,94,1.80563389998861,,0.2,135,136,133,1,-2
6,1,95,7,3,-4,86,45,82,4,92,1.74531839997508,,0.2,90,86,82,-4,-8
6,1,96,1,1,5,5,87,7,-2,96,2.17521610017866,,0.2,0,5,7,5,7
6,1,97,5,1,0,0,122,1,-1,98,2.75167070003226,,0.2,0,0,1,0,1
6,1,98,3,2,-8,37,7,38,-1,98,1.61809450015426,,0.2,45,37,38,-8,-7
6,1,99,10,3,-3,87,95,86,1,98,2.56357629992999,,0.2,90,87,86,-3,-4
6,1,100,4,2,-2,43,159,42,1,98,2.79358609998599,,0.2,45,43,42,-2,-3
6,1,101,1,2,9,54,168,43,11,78,1.90860390011221,,0.2,45,54,43,9,-2
6,1,102,2,2,7,52,80,51,1,98,1.49038939992897,,0.2,45,52,51,7,6
6,1,103,2,3,-3,87,66,83,4,92,2.95734389987774,,0.2,90,87,83,-3,-7
6,1,104,4,4,7,142,156,144,-2,96,1.4363849000074,,0.2,135,142,144,7,9
6,1,105,2,3,0,90,61,88,2,96,2.36311129992828,,0.2,90,90,88,0,-2
6,1,106,8,3,-3,87,6,86,1,98,2.59970500017516,,0.2,90,87,86,-3,-4
6,1,108,8,3,2,92,86,96,-4,92,2.35747310006991,,0.2,90,92,96,2,6
6,1,109,2,3,8,98,6,93,5,90,3.50248800008558,,0.2,90,98,93,8,3
6,1,110,1,2,-4,41,28,34,7,86,2.55725680012256,,0.2,45,41,34,-4,-11
6,1,112,7,2,-6,39,83,41,-2,96,2.01232679979876,,0.2,45,39,41,-6,-4
6,1,113,10,4,0,135,6,143,-8,84,1.2180337999016,,0.2,135,135,143,0,8
6,1,114,3,2,5,50,3,42,8,84,1.98770390008576,,0.2,45,50,42,5,-3
6,1,115,3,3,-2,88,60,86,2,96,3.35703859990463,,0.2,90,88,86,-2,-4
6,1,116,8,3,8,98,76,98,0,100,2.12713310006075,,0.2,90,98,98,8,8
6,1,117,2,2,9,54,88,58,-4,92,1.8359723999165,,0.2,45,54,58,9,13
6,1,118,7,4,5,140,43,147,-7,86,2.49054370005615,,0.2,135,140,147,5,12
6,1,119,8,1,-8,172,112,168,4,92,2.20584059995599,,0.2,0,-8,-12,-8,-12
6,1,120,5,4,4,139,13,148,-9,82,1.62989090010524,,0.2,135,139,148,4,13
6,1,121,7,3,9,99,23,111,-12,76,2.65411730017513,,0.2,90,99,111,9,21
6,1,122,2,2,1,46,68,31,15,70,2.31477369996719,,0.2,45,46,31,1,-14
6,1,123,5,3,7,97,65,101,-4,92,2.12120639998466,,0.2,90,97,101,7,11
6,1,124,2,4,-4,131,26,127,4,92,2.32701450004242,,0.2,135,131,127,-4,-8
6,1,125,4,1,-8,172,125,172,0,100,2.62379910005257,,0.2,0,-8,-8,-8,-8
6,1,126,4,1,4,4,19,5,-1,98,1.67836729995906,,0.2,0,4,5,4,5
6,1,127,4,4,-6,129,111,132,-3,94,1.66022389987484,,0.2,135,129,132,-6,-3
6,1,128,10,2,6,51,89,55,-4,92,2.23637300007977,,0.2,45,51,55,6,10
6,1,129,4,1,4,4,119,179,5,90,2.6179192001,,0.2,0,4,-1,4,-1
6,1,130,6,2,-3,42,132,43,-1,98,1.64234919985756,,0.2,45,42,43,-3,-2
6,1,131,5,1,2,2,127,0,2,96,2.81158489990048,,0.2,0,2,0,2,0
6,1,132,5,3,9,99,40,91,8,84,2.16332609998062,,0.2,90,99,91,9,1
6,1,133,7,2,2,47,53,49,-2,96,1.10898170014843,,0.2,45,47,49,2,4
6,1,134,9,2,9,54,135,56,-2,96,1.75734020001255,,0.2,45,54,56,9,11
6,1,135,8,4,-5,130,32,129,1,98,1.66662700008601,,0.2,135,130,129,-5,-6
6,1,136,4,4,4,139,164,144,-5,90,1.51515499991365,,0.2,135,139,144,4,9
6,1,137,2,4,10,145,141,141,4,92,0.715241800062358,,0.2,135,145,141,10,6
6,1,138,1,1,7,7,124,7,0,100,1.69084509997629,,0.2,0,7,7,7,7
6,1,139,6,2,2,47,18,47,0,100,1.49680180009454,,0.2,45,47,47,2,2
6,1,140,7,1,3,3,157,177,6,88,2.5452612999361,,0.2,0,3,-3,3,-3
6,1,141,5,4,-1,134,56,135,-1,98,2.04838520009071,,0.2,135,134,135,-1,0
6,1,142,2,3,4,94,42,96,-2,96,1.81753759994172,,0.2,90,94,96,4,6
6,1,143,3,1,-8,172,124,172,0,100,2.12710219994187,,0.2,0,-8,-8,-8,-8
6,1,144,7,2,-9,36,9,34,2,96,2.13893020013347,,0.2,45,36,34,-9,-11
6,1,145,2,1,-2,178,61,177,1,98,1.94533780007623,,0.2,0,-2,-3,-2,-3
6,1,146,8,1,-1,179,25,179,0,100,2.19972399994731,,0.2,0,-1,-1,-1,-1
6,1,147,6,3,7,97,136,92,5,90,2.10902580013499,,0.2,90,97,92,7,2
6,1,148,3,3,6,96,100,95,1,98,2.5026847999543,,0.2,90,96,95,6,5
6,1,149,3,4,9,144,137,143,1,98,1.30897699994966,,0.2,135,144,143,9,8
6,1,150,1,3,4,94,93,93,1,98,0.994053399888799,,0.2,90,94,93,4,3
6,1,151,8,1,-5,175,137,177,-2,96,2.46013189991936,,0.2,0,-5,-3,-5,-3
6,1,152,3,1,5,5,44,9,-4,92,2.05423240014352,,0.2,0,5,9,5,9
6,1,153,5,1,6,6,143,7,-1,98,2.52685389993712,,0.2,0,6,7,6,7
6,1,154,8,2,5,50,154,50,0,100,1.53909319988452,,0.2,45,50,50,5,5
6,1,155,1,1,-9,171,85,168,3,94,1.70848489995115,,0.2,0,-9,-12,-9,-12
6,1,156,6,2,8,53,166,55,-2,96,1.77546559995972,,0.2,45,53,55,8,10
6,1,157,4,1,4,4,19,4,0,100,1.23628480010666,,0.2,0,4,4,4,4
6,1,158,6,3,5,95,156,94,1,98,1.79978800006211,,0.2,90,95,94,5,4
6,1,159,3,2,-1,44,99,57,-13,74,1.58142170007341,,0.2,45,44,57,-1,12
6,1,160,2,4,-7,128,17,127,1,98,1.58758280007169,,0.2,135,128,127,-7,-8
7,1,1,3,1,8,8,17,10,-2,96,1.2667775999289,,0.2,0,8,10,8,10
7,1,2,5,2,-7,38,58,45,-7,86,2.56692139990628,,0.2,45,38,45,-7,0
7,1,3,1,3,-5,85,78,73,12,76,2.03325709979981,,0.2,90,85,73,-5,-17
7,1,4,8,3,1,91,174,92,-1,98,4.43353259982541,,0.2,90,91,92,1,2
7,1,5,6,2,9,54,113,54,0,100,3.23387210001238,,0.2,45,54,54,9,9
7,1,6,9,3,-6,84,58,84,0,100,2.06743740011007,,0.2,90,84,84,-6,-6
7,1,7,7,3,10,100,51,100,0,100,2.7986681999173,,0.2,90,100,100,10,10
7,1,8,3,1,0,0,64,172,8,84,4.23343450017273,,0.2,0,0,-8,0,-8
7,1,9,5,2,3,48,95,44,4,92,4.13613510015421,,0.2,45,48,44,3,-1
7,1,10,2,2,4,49,117,46,3,94,3.36596179986373,,0.2,45,49,46,4,1
7,1,11,3,1,-3,177,142,177,0,100,4.04789889999665,,0.2,0,-3,-3,-3,-3
7,1,12,10,4,-7,128,52,111,17,66,3.09991089999676,,0.2,135,128,111,-7,-24
7,1,13,7,3,-2,88,3,91,-3,94,3.86531040002592,,0.2,90,88,91,-2,1
7,1,14,9,4,0,135,139,135,0,100,1.36638509994373,,0.2,135,135,135,0,0
7,1,15,6,4,1,136,140,142,-6,88,1.00023630005307,,0.2,135,136,142,1,7
7,1,17,6,2,9,54,36,41,13,74,1.60016010003164,,0.2,45,54,41,9,-4
7,1,19,8,3,3,93,31,104,-11,78,3.16632690001279,,0.2,90,93,104,3,14
7,1,20,5,1,6,6,30,14,-8,84,1.23247360019013,,0.2,0,6,14,6,14
7,1,21,9,4,-2,133,78,132,1,98,3.0667465000879,,0.2,135,133,132,-2,-3
7,1,22,3,2,-4,41,69,39,2,96,1.96657119994052,,0.2,45,41,39,-4,-6
7,1,23,6,1,-9,171,164,166,5,90,1.96673810016364,,0.2,0,-9,-14,-9,-14
7,1,24,4,3,2,92,60,93,-1,98,2.70044909999706,,0.2,90,92,93,2,3
7,1,25,7,1,-3,177,55,177,0,100,3.10081080021337,,0.2,0,-3,-3,-3,-3
7,1,26,1,4,5,140,74,144,-4,92,3.53340019984171,,0.2,135,140,144,5,9
7,1,27,2,4,5,140,122,141,-1,98,1.29950970015489,,0.2,135,140,141,5,6
7,1,28,8,2,7,52,117,46,6,88,2.96653179987334,,0.2,45,52,46,7,1
7,1,30,5,2,4,49,9,48,1,98,3.59417120018043,,0.2,45,49,48,4,3
7,1,31,5,3,4,94,45,94,0,100,3.66609130008146,,0.2,90,94,94,4,4
7,1,32,1,2,8,53,112,37,16,68,4.36642220010981,,0.2,45,53,37,8,-8
7,1,33,10,2,-5,40,80,36,4,92,3.90018080011941,,0.2,45,40,36,-5,-9
7,1,34,7,3,-1,89,43,89,0,100,3.76668470003642,,0.2,90,89,89,-1,-1
7,1,35,6,3,-4,86,14,84,2,96,4.23274539993145,,0.2,90,86,84,-4,-6
7,1,36,4,1,-6,174,173,173,1,98,1.29997890000232,,0.2,0,-6,-7,-6,-7
7,1,37,5,3,-5,85,93,80,5,90,2.63307320000604,,0.2,90,85,80,-5,-10
7,1,38,1,2,2,47,56,46,1,98,2.86745929997414,,0.2,45,47,46,2,1
7,1,40,1,2,8,53,117,45,8,84,3.86767750000581,,0.2,45,53,45,8,0
7,1,41,10,1,9,9,0,10,-1,98,2.33219989994541,,0.2,0,9,10,9,10
7,1,43,8,1,-5,175,112,172,3,94,3.86596620013006,,0.2,0,-5,-8,-5,-8
7,1,44,1,3,-4,86,139,78,8,84,2.69961549993604,,0.2,90,86,78,-4,-12
7,1,45,9,2,-4,41,97,51,-10,80,2.16661860002205,,0.2,45,41,51,-4,6
7,1,46,6,2,7,52,116,55,-3,94,2.56694769999012,,0.2,45,52,55,7,10
7,1,47,7,4,-2,133,92,124,9,82,1.56361289997585,,0.2,135,133,124,-2,-11
7,1,48,8,2,4,49,107,61,-12,76,2.23106869985349,,0.2,45,49,61,4,16
7,1,49,3,2,-3,42,67,44,-2,96,1.66544739995152,,0.2,45,42,44,-3,-1
7,1,50,4,3,2,92,7,89,3,94,3.56575750000775,,0.2,90,92,89,2,-1
7,1,51,5,4,4,139,78,139,0,100,2.60035480000079,,0.2,135,139,139,4,4
7,1,52,6,3,4,94,48,94,0,100,2.06685460009612,,0.2,90,94,94,4,4
7,1,53,7,2,7,52,88,54,-2,96,1.86705749994144,,0.2,45,52,54,7,9
7,1,54,10,3,2,92,18,91,1,98,3.73478819988668,,0.2,90,92,91,2,1
7,1,55,8,2,-2,43,34,24,19,62,2.99949009995908,,0.2,45,43,24,-2,-21
7,1,57,7,1,3,3,162,14,-11,78,2.9315558001399,,0.2,0,3,14,3,14
7,1,58,2,1,9,9,72,3,6,88,2.99909180006944,,0.2,0,9,3,9,3
7,1,59,10,2,0,45,41,43,2,96,1.09961910010315,,0.2,45,45,43,0,-2
7,1,60,7,3,0,90,37,89,1,98,3.00014040013775,,0.2,90,90,89,0,-1
7,1,61,9,3,1,91,177,91,0,100,4.39823709987104,,0.2,90,91,91,1,1
7,1,62,6,3,4,94,89,98,-4,92,2.79916119994596,,0.2,90,94,98,4,8
7,1,63,8,4,-3,132,139,139,-7,86,0.80012260004878,,0.2,135,132,139,-3,4
7,1,64,1,1,-3,177,96,177,0,100,3.33355189999565,,0.2,0,-3,-3,-3,-3
7,1,66,2,1,6,6,138,7,-1,98,2.33394429995678,,0.2,0,6,7,6,7
7,1,67,3,4,9,144,62,142,2,96,3.79992299992591,,0.2,135,144,142,9,7
7,1,68,3,3,-4,86,107,89,-3,94,1.40062310011126,,0.2,90,86,89,-4,-1
7,1,69,4,2,0,45,113,55,-10,80,2.53385220002383,,0.2,45,45,55,0,10
7,1,70,8,4,-4,131,167,144,-13,74,1.73339410009794,,0.2,135,131,144,-4,9
7,1,71,2,2,-8,37,40,33,4,92,3.79935209988616,,0.2,45,37,33,-8,-12
7,1,72,2,4,-2,133,70,135,-2,96,3.66739760013297,,0.2,135,133,135,-2,0
7,1,73,7,4,3,138,104,145,-7,86,3.43261209991761,,0.2,135,138,145,3,10
7,1,74,9,1,-3,177,146,175,2,96,2.29956909990869,,0.2,0,-3,-5,-3,-5
7,1,75,5,3,-9,81,100,75,6,88,2.63411330012605,,0.2,90,81,75,-9,-15
7,1,76,4,2,2,47,40,40,7,86,1.19976690015756,,0.2,45,47,40,2,-5
7,1,77,4,3,2,92,93,93,-1,98,1.00084280013107,,0.2,90,92,93,2,3
7,1,78,3,3,3,93,151,90,3,94,3.49951229989529,,0.2,90,93,90,3,0
7,1,79,9,1,8,8,77,3,5,90,3.86608229996637,,0.2,0,8,3,8,3
7,1,81,6,3,-8,82,75,75,7,86,0.666575500043109,,0.2,90,82,75,-8,-15
7,1,82,5,1,-8,172,102,173,-1,98,3.56637759995647,,0.2,0,-8,-7,-8,-7
7,1,84,3,4,1,136,89,138,-2,96,2.46626839996316,,0.2,135,136,138,1,3
7,1,85,5,4,-7,128,114,129,-1,98,2.93310049991123,,0.2,135,128,129,-7,-6
7,1,86,1,1,0,0,11,1,-1,98,2.0998697001487,,0.2,0,0,1,0,1
7,1,87,9,1,3,3,45,2,1,98,2.63288499996997,,0.2,0,3,2,3,2
7,1,88,2,3,2,92,85,94,-2,96,1.56658999994397,,0.2,90,92,94,2,4
7,1,89,4,1,-5,175,174,176,-1,98,1.7330259999726,,0.2,0,-5,-4,-5,-4
7,1,90,3,1,9,9,1,13,-4,92,1.89963330002502,,0.2,0,9,13,9,13
7,1,91,5,4,-7,128,3,131,-3,94,2.99927609995939,,0.2,135,128,131,-7,-4
7,1,93,1,3,-8,82,70,75,7,86,1.43413009983487,,0.2,90,82,75,-8,-15
7,1,94,3,4,-6,129,65,129,0,100,3.56641780002974,,0.2,135,129,129,-6,-6
7,1,95,9,1,3,3,147,10,-7,86,3.00014759995975,,0.2,0,3,10,3,10
7,1,96,7,2,-2,43,49,40,3,94,1.76666680001654,,0.2,45,43,40,-2,-5
7,1,97,7,1,10,10,33,14,-4,92,2.76680589979514,,0.2,0,10,14,10,14
7,1,98,5,4,-7,128,48,137,-9,82,3.83303610002622,,0.2,135,128,137,-7,2
7,1,99,3,3,7,97,60,95,2,96,2.33320550015196,,0.2,90,97,95,7,5
7,1,100,10,4,9,144,60,141,3,94,3.23390690004453,,0.2,135,144,141,9,6
7,1,101,8,2,0,45,123,55,-10,80,2.86317140003666,,0.2,45,45,55,0,10
7,1,102,6,1,3,3,150,178,5,90,1.3995507999789,,0.2,0,3,-2,3,-2
7,1,103,3,2,5,50,175,37,13,74,1.533119100146,,0.2,45,50,37,5,-8
7,1,104,10,4,4,139,46,140,-1,98,3.76670760009438,,0.2,135,139,140,4,5
7,1,105,2,3,6,96,73,94,2,96,2.13272519991733,,0.2,90,96,94,6,4
7,1,106,1,4,4,139,164,147,-8,84,1.46694479999132,,0.2,135,139,147,4,12
7,1,108,6,4,-9,126,84,123,3,94,2.29943110002205,,0.2,135,126,123,-9,-12
7,1,109,3,2,-1,44,116,42,2,96,3.99952469998971,,0.2,45,44,42,-1,-3
7,1,111,4,2,4,49,119,53,-4,92,2.83364759990945,,0.2,45,49,53,4,8
7,1,112,4,1,2,2,119,6,-4,92,2.93311690003611,,0.2,0,2,6,2,6
7,1,113,10,1,-6,174,122,165,9,82,2.19967019977048,,0.2,0,-6,-15,-6,-15
7,1,114,1,1,-4,176,83,169,7,86,3.76630380004644,,0.2,0,-4,-11,-4,-11
7,1,115,1,4,1,136,92,137,-1,98,2.46800020011142,,0.2,135,136,137,1,2
7,1,116,9,4,7,142,59,134,8,84,2.99946740013547,,0.2,135,142,134,7,-1
7,1,117,4,4,9,144,76,138,6,88,3.53287650016136,,0.2,135,144,138,9,3
7,1,118,2,3,-8,82,36,69,13,74,1.60001210006885,,0.2,90,82,69,-8,-21
7,1,119,4,1,10,10,148,5,5,90,2.13296320009977,,0.2,0,10,5,10,5
7,1,120,10,2,9,54,156,44,10,80,2.93339070002548,,0.2,45,54,44,9,-1
7,1,121,8,3,6,96,53,98,-2,96,2.033782399958,,0.2,90,96,98,6,8
7,1,122,8,4,-3,132,34,154,-22,56,4.43200959987007,,0.2,135,132,154,-3,19
7,1,125,8,3,7,97,130,94,3,94,3.06386110000312,,0.2,90,97,94,7,4
7,1,127,7,4,-8,127,83,135,-8,84,2.16658720001578,,0.2,135,127,135,-8,0
7,1,128,1,4,6,141,95,149,-8,84,2.76691010012291,,0.2,135,141,149,6,14
7,1,129,7,4,-10,125,81,126,-1,98,2.36674319999292,,0.2,135,125,126,-10,-9
7,1,130,8,1,-7,173,171,175,-2,96,1.30093549983576,,0.2,0,-7,-5,-7,-5
7,1,131,2,4,-6,129,157,129,0,100,2.43294440000318,,0.2,135,129,129,-6,-6
7,1,132,7,2,-1,44,87,32,12,76,3.1329830000177,,0.2,45,44,32,-1,-13
7,1,133,10,4,1,136,164,134,2,96,4.066709500039,,0.2,135,136,134,1,-1
7,1,134,10,3,-5,85,14,85,0,100,3.99875820009038,,0.2,90,85,85,-5,-5
7,1,135,6,4,-6,129,122,134,-5,90,0.933410699944943,,0.2,135,129,134,-6,-1
7,1,136,6,4,-9,126,92,126,0,100,2.46705269999802,,0.2,135,126,126,-9,-9
7,1,137,5,1,1,1,177,0,1,98,1.40002259984612,,0.2,0,1,0,1,0
7,1,138,10,1,2,2,22,3,-1,98,1.69969830010086,,0.2,0,2,3,2,3
7,1,140,2,4,-5,130,133,124,6,88,2.29937230003998,,0.2,135,130,124,-5,-11
7,1,141,10,1,5,5,87,14,-9,82,4.21799849998206,,0.2,0,5,14,5,14
7,1,142,9,2,-7,38,97,34,4,92,3.03347110003233,,0.2,45,38,34,-7,-11
7,1,143,4,4,-2,133,37,126,7,86,3.26639040000737,,0.2,135,133,126,-2,-9
7,1,144,1,1,8,8,145,6,2,96,3.86673640017398,,0.2,0,8,6,8,6
7,1,145,2,1,7,7,162,8,-1,98,2.26765759987757,,0.2,0,7,8,7,8
7,1,146,1,3,-5,85,55,86,-1,98,3.13325969991274,,0.2,90,85,86,-5,-4
7,1,147,9,3,5,95,23,93,2,96,3.26741080009378,,0.2,90,95,93,5,3
7,1,148,10,3,5,95,110,103,-8,84,2.16633650008589,,0.2,90,95,103,5,13
7,1,149,10,2,2,47,119,53,-6,88,2.73336800001562,,0.2,45,47,53,2,8
7,1,150,9,2,-3,42,161,33,9,82,3.3993375999853,,0.2,45,42,33,-3,-12
7,1,151,5,3,-5,85,71,89,-4,92,1.36578359990381,,0.2,90,85,89,-5,-1
7,1,152,4,3,4,94,107,95,-1,98,1.53346399986185,,0.2,90,94,95,4,5
7,1,153,9,3,2,92,51,93,-1,98,4.06649910006672,,0.2,90,92,93,2,3
7,1,154,4,2,2,47,34,39,8,84,1.80004919995554,,0.2,45,47,39,2,-6
7,1,155,9,2,7,52,36,55,-3,94,2.40040259994566,,0.2,45,52,55,7,10
7,1,157,2,3,6,96,3,104,-8,84,3.83331570005976,,0.2,90,96,104,6,14
7,1,158,10,3,-10,80,120,76,4,92,2.66581190004945,,0.2,90,80,76,-10,-14
7,1,159,5,1,1,1,93,8,-7,86,4.0990597999189,,0.2,0,1,8,1,8
7,1,160,8,4,8,143,175,145,-2,96,1.99929130007513,,0.2,135,143,145,8,10
8,1,1,3,1,8,8,17,8,0,100,2.82366260001436,,0.2,0,8,8,8,8
8,1,2,5,2,-7,38,58,46,-8,84,1.38795859995298,,0.2,45,38,46,-7,1
8,1,3,1,3,-5,85,78,84,1,98,3.34486239985563,,0.2,90,85,84,-5,-6
8,1,5,6,2,9,54,113,69,-15,70,1.60074339993298,,0.2,45,54,69,9,24
8,1,6,9,3,-6,84,58,82,2,96,2.18143870006315,,0.2,90,84,82,-6,-8
8,1,7,7,3,10,100,51,99,1,98,2.2967393998988,,0.2,90,100,99,10,9
8,1,8,3,1,0,0,64,173,7,86,3.03016449999996,,0.2,0,0,-7,0,-7
8,1,9,5,2,3,48,95,50,-2,96,1.96967540006153,,0.2,45,48,50,3,5
8,1,10,2,2,4,49,117,50,-1,98,1.65422350005247,,0.2,45,49,50,4,5
8,1,11,3,1,-3,177,142,178,-1,98,2.02427569986321,,0.2,0,-3,-2,-3,-2
8,1,12,10,4,-7,128,52,142,-14,72,1.98820840008557,,0.2,135,128,142,-7,7
8,1,13,7,3,-2,88,3,88,0,100,2.53303080005571,,0.2,90,88,88,-2,-2
8,1,14,9,4,0,135,139,127,8,84,1.35732309985906,,0.2,135,135,127,0,-8
8,1,15,6,4,1,136,140,136,0,100,2.01183880004101,,0.2,135,136,136,1,1
8,1,16,2,1,-7,173,36,174,-1,98,2.55772809986956,,0.2,0,-7,-6,-7,-6
8,1,17,6,2,9,54,36,55,-1,98,2.47896129987203,,0.2,45,54,55,9,10
8,1,18,9,4,-6,129,83,123,6,88,2.97523669991642,,0.2,135,129,123,-6,-12
8,1,19,8,3,3,93,31,94,-1,98,2.32093470008112,,0.2,90,93,94,3,4
8,1,20,5,1,6,6,30,10,-4,92,3.81702880002558,,0.2,0,6,10,6,10
8,1,22,3,2,-4,41,69,35,6,88,3.72634840011597,,0.2,45,41,35,-4,-10
8,1,23,6,1,-9,171,164,169,2,96,2.18178700003773,,0.2,0,-9,-11,-9,-11
8,1,24,4,3,2,92,60,93,-1,98,3.66039970004931,,0.2,90,92,93,2,3
8,1,25,7,1,-3,177,55,175,2,96,2.49663170007989,,0.2,0,-3,-5,-3,-5
8,1,27,2,4,5,140,122,155,-15,70,2.64210059982724,,0.2,135,140,155,5,20
8,1,28,8,2,7,52,117,63,-11,78,2.50284150009975,,0.2,45,52,63,7,18
8,1,29,7,2,-4,41,31,48,-7,86,2.54532539984211,,0.2,45,41,48,-4,3
8,1,30,5,2,4,49,9,45,4,92,3.8055809000507,,0.2,45,49,45,4,0
8,1,31,5,3,4,94,45,95,-1,98,2.1819021999836,,0.2,90,94,95,4,5
8,1,32,1,2,8,53,112,74,-21,58,2.84818040020764,,0.2,45,53,74,8,29
8,1,33,10,2,-5,40,80,54,-14,72,2.40583399985917,,0.2,45,40,54,-5,9
8,1,34,7,3,-1,89,43,90,-1,98,1.90259780013002,,0.2,90,89,90,-1,0
8,1,35,6,3,-4,86,14,85,1,98,3.09061959991232,,0.2,90,86,85,-4,-5
8,1,36,4,1,-6,174,173,173,1,98,2.41838799999095,,0.2,0,-6,-7,-6,-7
8,1,37,5,3,-5,85,93,84,1,98,1.94481349992566,,0.2,90,85,84,-5,-6
8,1,38,1,2,2,47,56,56,-9,82,2.61756399995647,,0.2,45,47,56,2,11
8,1,39,1,2,3,48,166,39,9,82,2.7088333000429,,0.2,45,48,39,3,-6
8,1,41,10,1,9,9,0,9,0,100,1.97535270010121,,0.2,0,9,9,9,9
8,1,42,3,3,-4,86,150,83,3,94,2.01797050004825,,0.2,90,86,83,-4,-7
8,1,43,8,1,-5,175,112,174,1,98,3.19377860007808,,0.2,0,-5,-6,-5,-6
8,1,44,1,3,-4,86,139,88,-2,96,3.49643579986878,,0.2,90,86,88,-4,-2
8,1,46,6,2,7,52,116,61,-9,82,1.86061040009372,,0.2,45,52,61,7,16
8,1,47,7,4,-2,133,92,122,11,78,1.92118460009806,,0.2,135,133,122,-2,-13
8,1,48,8,2,4,49,107,56,-7,86,2.35114629985765,,0.2,45,49,56,4,11
8,1,49,3,2,-3,42,67,38,4,92,3.72096449998207,,0.2,45,42,38,-3,-7
8,1,50,4,3,2,92,7,99,-7,86,3.339539000066,,0.2,90,92,99,2,9
8,1,52,6,3,4,94,48,97,-3,94,2.07210729992948,,0.2,90,94,97,4,7
8,1,53,7,2,7,52,88,56,-4,92,3.67841090005822,,0.2,45,52,56,7,11
8,1,54,10,3,2,92,18,99,-7,86,2.24770489986986,,0.2,90,92,99,2,9
8,1,55,8,2,-2,43,34,45,-2,96,2.18759809993207,,0.2,45,43,45,-2,0
8,1,56,6,1,3,3,139,6,-3,94,2.54527830006555,,0.2,0,3,6,3,6
8,1,57,7,1,3,3,162,8,-5,90,1.70864229998551,,0.2,0,3,8,3,8
8,1,58,2,1,9,9,72,14,-5,90,2.89036690001376,,0.2,0,9,14,9,14
8,1,59,10,2,0,45,41,41,4,92,3.07221319992095,,0.2,45,45,41,0,-4
8,1,60,7,3,0,90,37,89,1,98,2.04841530020349,,0.2,90,90,89,0,-1
8,1,61,9,3,1,91,177,92,-1,98,3.46044019982219,,0.2,90,91,92,1,2
8,1,62,6,3,4,94,89,102,-8,84,3.1756166999694,,0.2,90,94,102,4,12
8,1,63,8,4,-3,132,139,110,22,56,2.15676559996791,,0.2,135,132,110,-3,-25
8,1,64,1,1,-3,177,96,174,3,94,2.69092660001479,,0.2,0,-3,-6,-3,-6
8,1,65,7,1,-8,172,31,173,-1,98,1.5816156999208,,0.2,0,-8,-7,-8,-7
8,1,66,2,1,6,6,138,8,-2,96,2.40557339997031,,0.2,0,6,8,6,8
8,1,67,3,4,9,144,62,150,-6,88,3.36338910018094,,0.2,135,144,150,9,15
8,1,68,3,3,-4,86,107,87,-1,98,3.47214449988678,,0.2,90,86,87,-4,-3
8,1,69,4,2,0,45,113,66,-21,58,2.15722479997203,,0.2,45,45,66,0,21
8,1,70,8,4,-4,131,167,135,-4,92,3.64238430000842,,0.2,135,131,135,-4,0
8,1,71,2,2,-8,37,40,50,-13,74,2.56910640001297,,0.2,45,37,50,-8,5
8,1,72,2,4,-2,133,70,113,20,60,1.47871749987826,,0.2,135,133,113,-2,-22
8,1,73,7,4,3,138,104,132,6,88,2.69658230012283,,0.2,135,138,132,3,-3
8,1,74,9,1,-3,177,146,178,-1,98,2.11448939982802,,0.2,0,-3,-2,-3,-2
8,1,75,5,3,-9,81,100,83,-2,96,2.42344349995255,,0.2,90,81,83,-9,-7
8,1,76,4,2,2,47,40,57,-10,80,3.93214779999107,,0.2,45,47,57,2,12
8,1,77,4,3,2,92,93,93,-1,98,1.06671350006945,,0.2,90,92,93,2,3
8,1,78,3,3,3,93,151,95,-2,96,2.13894319999963,,0.2,90,93,95,3,5
8,1,79,9,1,8,8,77,8,0,100,3.38740990008228,,0.2,0,8,8,8,8
8,1,81,6,3,-8,82,75,77,5,90,1.96941999997944,,0.2,90,82,77,-8,-13
8,1,82,5,1,-8,172,102,172,0,100,3.12076760013588,,0.2,0,-8,-8,-8,-8
8,1,84,3,4,1,136,89,130,6,88,1.95150700001977,,0.2,135,136,130,1,-5
8,1,85,5,4,-7,128,114,129,-1,98,1.16983029991388,,0.2,135,128,129,-7,-6
8,1,86,1,1,0,0,11,4,-4,92,1.46653899992816,,0.2,0,0,4,0,4
8,1,87,9,1,3,3,45,3,0,100,3.82381660002284,,0.2,0,3,3,3,3
8,1,88,2,3,2,92,85,93,-1,98,2.02350639994256,,0.2,90,92,93,2,3
8,1,89,4,1,-5,175,174,174,1,98,1.03628230001777,,0.2,0,-5,-6,-5,-6
8,1,90,3,1,9,9,1,8,1,98,2.06619659997523,,0.2,0,9,8,9,8
8,1,91,5,4,-7,128,3,140,-12,76,2.04216770012863,,0.2,135,128,140,-7,5
8,1,92,2,2,7,52,158,41,11,78,3.09032910014503,,0.2,45,52,41,7,-4
8,1,93,1,3,-8,82,70,77,5,90,2.01192629989237,,0.2,90,82,77,-8,-13
8,1,94,3,4,-6,129,65,118,11,78,2.17578449985012,,0.2,135,129,118,-6,-17
8,1,95,9,1,3,3,147,8,-5,90,1.8175814000424,,0.2,0,3,8,3,8
8,1,96,7,2,-2,43,49,31,12,76,2.04769279994071,,0.2,45,43,31,-2,-14
8,1,97,7,1,10,10,33,14,-4,92,1.41823059995659,,0.2,0,10,14,10,14
8,1,98,5,4,-7,128,48,126,2,96,2.67845070012845,,0.2,135,128,126,-7,-9
8,1,99,3,3,7,97,60,101,-4,92,1.74523860006593,,0.2,90,97,101,7,11
8,1,100,10,4,9,144,60,148,-4,92,3.00588060007431,,0.2,135,144,148,9,13
8,1,101,8,2,0,45,123,53,-8,84,2.55700589995831,,0.2,45,45,53,0,8
8,1,102,6,1,3,3,150,6,-3,94,1.65487290010788,,0.2,0,3,6,3,6
8,1,104,10,4,4,139,46,140,-1,98,3.06032859999686,,0.2,135,139,140,4,5
8,1,105,2,3,6,96,73,94,2,96,2.52094530011527,,0.2,90,96,94,6,4
8,1,106,1,4,4,139,164,137,2,96,1.87838630005717,,0.2,135,139,137,4,2
8,1,107,8,1,-8,172,161,161,11,78,3.02347039990127,,0.2,0,-8,-19,-8,-19
8,1,108,6,4,-9,126,84,118,8,84,1.5085999998264,,0.2,135,126,118,-9,-17
8,1,109,3,2,-1,44,116,53,-9,82,1.83558390010148,,0.2,45,44,53,-1,8
8,1,110,8,1,4,4,122,3,1,98,3.0301274000667,,0.2,0,4,3,4,3
8,1,111,4,2,4,49,119,40,9,82,2.82428749999963,,0.2,45,49,40,4,-5
8,1,112,4,1,2,2,119,2,0,100,2.6787292000372,,0.2,0,2,2,2,2
8,1,113,10,1,-6,174,122,174,0,100,1.62368210009299,,0.2,0,-6,-6,-6,-6
8,1,114,1,1,-4,176,83,172,4,92,2.05443120002747,,0.2,0,-4,-8,-4,-8
8,1,115,1,4,1,136,92,126,10,80,1.70882910001092,,0.2,135,136,126,1,-9
8,1,117,4,4,9,144,76,134,10,80,2.95114570017904,,0.2,135,144,134,9,-1
8,1,118,2,3,-8,82,36,80,2,96,3.24789529992267,,0.2,90,82,80,-8,-10
8,1,119,4,1,10,10,148,8,2,96,1.50261160009541,,0.2,0,10,8,10,8
8,1,120,10,2,9,54,156,46,8,84,2.13306610006839,,0.2,45,54,46,9,1
8,1,121,8,3,6,96,53,96,0,100,1.38789480016567,,0.2,90,96,96,6,6
8,1,123,5,2,6,51,168,66,-15,70,3.1451303998474,,0.2,45,51,66,6,21
8,1,124,4,4,2,137,172,141,-4,92,1.85437229997478,,0.2,135,137,141,2,6
8,1,125,8,3,7,97,130,103,-6,88,2.20547419996001,,0.2,90,97,103,7,13
8,1,126,6,2,-4,41,26,46,-5,90,3.19350619986653,,0.2,45,41,46,-4,1
8,1,127,7,4,-8,127,83,119,8,84,1.46639369986951,,0.2,135,127,119,-8,-16
8,1,128,1,4,6,141,95,134,7,86,2.43588250014,,0.2,135,141,134,6,-1
8,1,129,7,4,-10,125,81,111,14,72,1.22409259993583,,0.2,135,125,111,-10,-24
8,1,130,8,1,-7,173,171,171,2,96,1.72092409990728,,0.2,0,-7,-9,-7,-9
8,1,131,2,4,-6,129,157,128,1,98,1.3451761000324,,0.2,135,129,128,-6,-7
8,1,132,7,2,-1,44,87,52,-8,84,2.34550419985317,,0.2,45,44,52,-1,7
8,1,133,10,4,1,136,164,134,2,96,1.58700870000757,,0.2,135,136,134,1,-1
8,1,134,10,3,-5,85,14,81,4,92,2.7573913000524,,0.2,90,85,81,-5,-9
8,1,135,6,4,-6,129,122,134,-5,90,2.10917469998822,,0.2,135,129,134,-6,-1
8,1,136,6,4,-9,126,92,119,7,86,1.39981049997732,,0.2,135,126,119,-9,-16
8,1,137,5,1,1,1,177,7,-6,88,2.0361327000428,,0.2,0,1,7,1,7
8,1,138,10,1,2,2,22,4,-2,96,1.78771440009587,,0.2,0,2,4,2,4
8,1,139,6,1,-6,174,91,175,-1,98,3.3816221000161,,0.2,0,-6,-5,-6,-5
8,1,140,2,4,-5,130,133,133,-3,94,1.12113099987619,,0.2,135,130,133,-5,-2
8,1,141,10,1,5,5,87,4,1,98,2.7874238002114,,0.2,0,5,4,5,4
8,1,142,9,2,-7,38,97,35,3,94,2.2239226999227,,0.2,45,38,35,-7,-10
8,1,143,4,4,-2,133,37,145,-12,76,1.85435630008578,,0.2,135,133,145,-2,10
8,1,144,1,1,8,8,145,7,1,98,2.48447490017861,,0.2,0,8,7,8,7
8,1,145,2,1,7,7,162,7,0,100,1.70874219993129,,0.2,0,7,7,7,7
8,1,146,1,3,-5,85,55,76,9,82,1.75684910011478,,0.2,90,85,76,-5,-14
8,1,147,9,3,5,95,23,97,-2,96,2.51461739977822,,0.2,90,95,97,5,7
8,1,148,10,3,5,95,110,96,-1,98,1.45458670007065,,0.2,90,95,96,5,6
8,1,149,10,2,2,47,119,57,-10,80,4.065947300056,,0.2,45,47,57,2,12
8,1,150,9,2,-3,42,161,34,8,84,2.8240018999204,,0.2,45,42,34,-3,-11
8,1,151,5,3,-5,85,71,77,8,84,2.54550560005009,,0.2,90,85,77,-5,-13
8,1,152,4,3,4,94,107,94,0,100,2.0726817001123,,0.2,90,94,94,4,4
8,1,153,9,3,2,92,51,85,7,86,2.84798550000414,,0.2,90,92,85,2,-5
8,1,154,4,2,2,47,34,43,4,92,2.65991090005264,,0.2,45,47,43,2,-2
8,1,155,9,2,7,52,36,41,11,78,1.77561859996058,,0.2,45,52,41,7,-4
8,1,156,2,2,-6,39,79,33,6,88,1.92019529989921,,0.2,45,39,33,-6,-12
8,1,157,2,3,6,96,3,97,-1,98,2.29652069997974,,0.2,90,96,97,6,7
8,1,158,10,3,-10,80,120,84,-4,92,1.59336509997956,,0.2,90,80,84,-10,-6
8,1,159,5,1,1,1,93,2,-1,98,3.79362929984927,,0.2,0,1,2,1,2
8,1,160,8,4,8,143,175,157,-14,72,2.66060649999417,,0.2,135,143,157,8,22
9,1,1,3,3,6,96,122,98,-2,96,2.53224619990215,,0.2,90,96,98,6,8
9,1,2,6,4,7,142,153,136,6,88,3.43014950002544,,0.2,135,142,136,7,1
9,1,3,10,1,-4,176,149,172,4,92,2.91435620002449,,0.2,0,-4,-8,-4,-8
9,1,5,8,1,-8,172,125,175,-3,94,3.40032069990411,,0.2,0,-8,-5,-8,-5
9,1,6,10,3,6,96,55,95,1,98,4.10215479996987,,0.2,90,96,95,6,5
9,1,7,3,4,-6,129,91,126,3,94,2.37606049980968,,0.2,135,129,126,-6,-9
9,1,8,3,1,-7,173,163,173,0,100,3.2416877001524,,0.2,0,-7,-7,-7,-7
9,1,9,10,2,8,53,3,59,-6,88,3.11482210014947,,0.2,45,53,59,8,14
9,1,10,10,4,-6,129,66,122,7,86,2.90902830008417,,0.2,135,129,122,-6,-13
9,1,11,4,4,-9,126,18,119,7,86,3.0904943998903,,0.2,135,126,119,-9,-16
9,1,12,6,3,-2,88,45,97,-9,82,3.24770880001597,,0.2,90,88,97,-2,7
9,1,14,1,1,-1,179,60,0,-1,98,3.24794130004011,,0.2,0,-1,0,-1,0
9,1,15,1,3,-5,85,4,84,1,98,4.11497720004991,,0.2,90,85,84,-5,-6
9,1,16,1,3,0,90,50,93,-3,94,4.04716900014319,,0.2,90,90,93,0,3
9,1,18,2,3,10,100,91,101,-1,98,1.3753881000448,,0.2,90,100,101,10,11
9,1,19,4,2,3,48,177,37,11,78,3.0114648998715,,0.2,45,48,37,3,-8
9,1,20,10,3,-1,89,27,85,4,92,3.58145610010251,,0.2,90,89,85,-1,-5
9,1,21,2,4,-2,133,10,126,7,86,2.6538084000349,,0.2,135,133,126,-2,-9
9,1,22,6,2,-8,37,105,35,2,96,3.145388700068,,0.2,45,37,35,-8,-10
9,1,23,8,3,7,97,11,102,-5,90,3.82398060010746,,0.2,90,97,102,7,12
9,1,24,4,2,-6,39,17,34,5,90,2.79981789994054,,0.2,45,39,34,-6,-11
9,1,25,5,1,5,5,152,9,-4,92,2.57539290003479,,0.2,0,5,9,5,9
9,1,26,5,2,-6,39,151,37,2,96,2.54560089996085,,0.2,45,39,37,-6,-8
9,1,27,5,1,-9,171,134,171,0,100,2.48403519997373,,0.2,0,-9,-9,-9,-9
9,1,28,5,3,-2,88,151,85,3,94,3.01800399995409,,0.2,90,88,85,-2,-5
9,1,29,6,2,-1,44,121,43,1,98,3.70872660004534,,0.2,45,44,43,-1,-2
9,1,30,8,2,9,54,110,49,5,90,3.02334720012732,,0.2,45,54,49,9,4
9,1,31,8,1,3,3,107,9,-6,88,2.68485439987853,,0.2,0,3,9,3,9
9,1,32,10,2,5,50,56,38,12,76,1.78736860002391,,0.2,45,50,38,5,-7
9,1,33,2,1,-7,173,106,176,-3,94,4.20539569994435,,0.2,0,-7,-4,-7,-4
9,1,34,10,1,2,2,81,3,-1,98,3.51467919978313,,0.2,0,2,3,2,3
9,1,35,9,3,-4,86,133,87,-1,98,2.90850499994121,,0.2,90,86,87,-4,-3
9,1,37,6,4,-9,126,69,128,-2,96,3.26647699996829,,0.2,135,126,128,-9,-7
9,1,38,7,3,-5,85,59,83,2,96,2.04805710003711,,0.2,90,85,83,-5,-7
9,1,39,5,3,-6,84,160,83,1,98,3.10882330010645,,0.2,90,84,83,-6,-7
9,1,40,6,4,-4,131,118,137,-6,88,1.94510549982078,,0.2,135,131,137,-4,2
9,1,41,5,3,-10,80,128,76,4,92,3.44808020000346,,0.2,90,80,76,-10,-14
9,1,42,2,2,3,48,23,45,3,94,2.81182750011794,,0.2,45,48,45,3,0
9,1,43,5,2,5,50,155,46,4,92,3.19957389985211,,0.2,45,50,46,5,1
9,1,44,2,4,-7,128,158,130,-2,96,2.00572620006278,,0.2,135,128,130,-7,-5
9,1,45,5,2,1,46,100,48,-2,96,2.6235738999676,,0.2,45,46,48,1,3
9,1,46,2,2,4,49,25,45,4,92,1.99311010004021,,0.2,45,49,45,4,0
9,1,47,2,2,-8,37,99,39,-2,96,3.63648530002683,,0.2,45,37,39,-8,-6
9,1,48,4,1,2,2,59,7,-5,90,3.12057300005108,,0.2,0,2,7,2,7
9,1,49,1,4,2,137,142,136,1,98,1.79404619988054,,0.2,135,137,136,2,1
9,1,50,2,1,-10,170,56,169,1,98,3.78732000011951,,0.2,0,-10,-11,-10,-11
9,1,51,9,2,7,52,121,56,-4,92,4.0293485999573,,0.2,45,52,56,7,11
9,1,52,3,1,9,9,56,9,0,100,3.64192260010168,,0.2,0,9,9,9,9
9,1,53,10,4,6,141,18,149,-8,84,2.90865019988269,,0.2,135,141,149,6,14
9,1,54,8,1,-6,174,59,159,15,70,3.90877450001426,,0.2,0,-6,-21,-6,-21
9,1,55,7,1,2,2,120,4,-2,96,3.67230610013939,,0.2,0,2,4,2,4
9,1,56,5,2,5,50,166,34,16,68,2.25421839999035,,0.2,45,50,34,5,-11
9,1,57,2,2,-10,35,19,35,0,100,1.66049300017767,,0.2,45,35,35,-10,-10
9,1,58,1,1,1,1,5,1,0,100,2.46649240003899,,0.2,0,1,1,1,1
9,1,59,1,4,-10,125,1,130,-5,90,2.82400000002235,,0.2,135,125,130,-10,-5
9,1,60,9,1,-1,179,90,178,1,98,3.42981679993682,,0.2,0,-1,-2,-1,-2
9,1,61,7,1,-5,175,60,170,5,90,3.86029470013455,,0.2,0,-5,-10,-5,-10
9,1,62,9,3,-1,89,77,85,4,92,3.61762750009075,,0.2,90,89,85,-1,-5
9,1,63,8,4,0,135,137,132,3,94,2.78740380005911,,0.2,135,135,132,0,-3
9,1,64,8,1,2,2,27,4,-2,96,3.07819909998216,,0.2,0,2,4,2,4
9,1,65,4,4,-9,126,5,126,0,100,3.15142679982819,,0.2,135,126,126,-9,-9
9,1,66,4,1,-7,173,165,173,0,100,1.78789089992642,,0.2,0,-7,-7,-7,-7
9,1,67,6,1,6,6,174,6,0,100,1.84218510007486,,0.2,0,6,6,6,6
9,1,68,1,1,3,3,65,2,1,98,3.21179430000484,,0.2,0,3,2,3,2
9,1,69,1,2,0,45,178,37,8,84,1.87854419997893,,0.2,45,45,37,0,-8
9,1,70,8,4,6,141,151,151,-10,80,1.83617759984918,,0.2,135,141,151,6,16
9,1,71,4,3,9,99,139,100,-1,98,4.19955610018224,,0.2,90,99,100,9,10
9,1,72,7,2,2,47,132,37,10,80,4.43586430000141,,0.2,45,47,37,2,-8
9,1,73,10,4,-9,126,146,121,5,90,2.88443130021915,,0.2,135,126,121,-9,-14
9,1,74,5,4,-8,127,98,121,6,88,2.12672990001738,,0.2,135,127,121,-8,-14
9,1,75,4,2,1,46,137,44,2,96,3.09021689998917,,0.2,45,46,44,1,-1
9,1,76,9,4,3,138,98,134,4,92,2.02376849995926,,0.2,135,138,134,3,-1
9,1,77,4,1,-1,179,139,178,1,98,3.51439839997329,,0.2,0,-1,-2,-1,-2
9,1,78,7,1,-4,176,74,172,4,92,4.1383431002032,,0.2,0,-4,-8,-4,-8
9,1,79,5,4,1,136,64,148,-12,76,3.91432259976864,,0.2,135,136,148,1,13
9,1,80,3,2,-1,44,46,46,-2,96,2.22397110005841,,0.2,45,44,46,-1,1
9,1,81,6,3,6,96,106,93,3,94,2.48433879995719,,0.2,90,96,93,6,3
9,1,82,6,2,-5,40,54,36,4,92,2.67212220001966,,0.2,45,40,36,-5,-9
9,1,83,7,4,-4,131,127,129,2,96,2.57555310009047,,0.2,135,131,129,-4,-6
9,1,84,1,1,-6,174,106,177,-3,94,3.93240190017968,,0.2,0,-6,-3,-6,-3
9,1,85,8,4,-6,129,92,116,13,74,2.94480139994994,,0.2,135,129,116,-6,-19
9,1,86,1,4,-2,133,93,129,4,92,2.24186700000428,,0.2,135,133,129,-2,-6
9,1,87,1,3,-4,86,28,83,3,94,3.8717944000382,,0.2,90,86,83,-4,-7
9,1,89,3,3,-9,81,99,77,4,92,1.9084976001177,,0.2,90,81,77,-9,-13
9,1,90,7,2,-5,40,63,44,-4,92,2.42350480007008,,0.2,45,40,44,-5,-1
9,1,91,3,4,-5,130,127,127,3,94,1.53934769984335,,0.2,135,130,127,-5,-8
9,1,92,3,1,4,4,96,4,0,100,3.81125320005231,,0.2,0,4,4,4,4
9,1,93,2,1,-6,174,25,173,1,98,2.70249880012125,,0.2,0,-6,-7,-6,-7
9,1,94,7,4,-8,127,7,115,12,76,2.32660740008578,,0.2,135,127,115,-8,-20
9,1,95,2,1,-5,175,157,168,7,86,2.70881909993477,,0.2,0,-5,-12,-5,-12
9,1,96,8,3,-4,86,2,86,0,100,4.50251749996096,,0.2,90,86,86,-4,-4
9,1,97,4,3,-7,83,179,83,0,100,3.59297830006108,,0.2,90,83,83,-7,-7
9,1,98,7,3,7,97,144,96,1,98,3.3390144999139,,0.2,90,97,96,7,6
9,1,99,2,3,-3,87,170,84,3,94,3.63603330007754,,0.2,90,87,84,-3,-6
9,1,100,10,3,3,93,116,96,-3,94,2.60022810008377,,0.2,90,93,96,3,6
9,1,101,6,3,-8,82,115,79,3,94,2.42403419991024,,0.2,90,82,79,-8,-11
9,1,102,1,2,0,45,31,51,-6,88,2.03690299997106,,0.2,45,45,51,0,6
9,1,103,9,2,7,52,21,46,6,88,2.61190639995039,,0.2,45,52,46,7,1
9,1,104,10,1,6,6,127,4,2,96,2.60562179982662,,0.2,0,6,4,6,4
9,1,105,1,3,-8,82,168,80,2,96,3.81844320008531,,0.2,90,82,80,-8,-10
9,1,106,8,4,-3,132,172,137,-5,90,2.7574333997909,,0.2,135,132,137,-3,2
9,1,108,3,2,-4,41,46,46,-5,90,0.75791439996101,,0.2,45,41,46,-4,1
9,1,109,8,2,10,55,9,45,10,80,1.95738280005753,,0.2,45,55,45,10,0
9,1,110,3,4,3,138,73,134,4,92,2.9631566000171,,0.2,135,138,134,3,-1
9,1,111,2,3,-4,86,121,83,3,94,2.44206620007753,,0.2,90,86,83,-4,-7
9,1,112,9,1,4,4,18,4,0,100,2.47243899991736,,0.2,0,4,4,4,4
9,1,113,1,2,8,53,69,57,-4,92,1.67840990005061,,0.2,45,53,57,8,12
9,1,114,3,1,-9,171,31,172,-1,98,2.2235277001746,,0.2,0,-9,-8,-9,-8
9,1,115,5,4,-5,130,58,136,-6,88,3.36877419985831,,0.2,135,130,136,-5,1
9,1,116,1,2,2,47,146,41,6,88,2.87831429997459,,0.2,45,47,41,2,-4
9,1,117,9,1,5,5,22,6,-1,98,2.34503570012748,,0.2,0,5,6,5,6
9,1,118,7,4,-9,126,56,113,13,74,4.06606830004603,,0.2,135,126,113,-9,-22
9,1,119,6,1,6,6,118,6,0,100,2.80557000008412,,0.2,0,6,6,6,6
9,1,120,4,3,4,94,110,98,-4,92,2.26014450006187,,0.2,90,94,98,4,8
9,1,121,5,3,4,94,105,95,-1,98,2.32119109993801,,0.2,90,94,95,4,5
9,1,122,9,3,1,91,55,89,2,96,3.59941279981285,,0.2,90,91,89,1,-1
9,1,123,9,2,4,49,1,45,4,92,2.67837919993326,,0.2,45,49,45,4,0
9,1,124,9,4,-5,130,112,133,-3,94,2.5866014000494,,0.2,135,130,133,-5,-2
9,1,125,6,4,-6,129,5,138,-9,82,2.76909660012461,,0.2,135,129,138,-6,3
9,1,126,4,1,9,9,162,10,-1,98,2.81182410009205,,0.2,0,9,10,9,10
9,1,127,8,2,-5,40,9,35,5,90,2.6419480999466,,0.2,45,40,35,-5,-10
9,1,128,7,3,-7,83,149,85,-2,96,4.50255950004794,,0.2,90,83,85,-7,-5
9,1,129,6,2,-9,36,126,30,6,88,4.49667759984732,,0.2,45,36,30,-9,-15
9,1,130,4,2,-5,40,158,41,-1,98,2.96923289983533,,0.2,45,40,41,-5,-4
9,1,131,2,4,-10,125,99,111,14,72,1.46599860000424,,0.2,135,125,111,-10,-24
9,1,132,7,3,7,97,77,95,2,96,1.993733700132,,0.2,90,97,95,7,5
9,1,133,7,2,6,51,44,54,-3,94,1.59376289998181,,0.2,45,51,54,6,9
9,1,134,1,4,0,135,35,136,-1,98,3.67721230001189,,0.2,135,135,136,0,1
9,1,135,8,2,8,53,6,40,13,74,2.67251449986361,,0.2,45,53,40,8,-5
9,1,136,8,3,6,96,138,93,3,94,2.66663310001604,,0.2,90,96,93,6,3
9,1,137,10,1,9,9,129,9,0,100,3.33293830021285,,0.2,0,9,9,9,9
9,1,138,8,3,-10,80,103,75,5,90,2.57541440008208,,0.2,90,80,75,-10,-15
9,1,139,4,4,6,141,44,145,-4,92,2.92677900008857,,0.2,135,141,145,6,10
9,1,140,6,3,3,93,112,92,1,98,1.87881560018286,,0.2,90,93,92,3,2
9,1,141,10,2,-1,44,133,36,8,84,3.50854589999653,,0.2,45,44,36,-1,-9
9,1,142,7,1,-2,178,141,177,1,98,2.59367740014568,,0.2,0,-2,-3,-2,-3
9,1,143,4,4,3,138,162,138,0,100,1.88444989989512,,0.2,135,138,138,3,3
9,1,144,3,3,4,94,144,90,4,92,3.05373270018026,,0.2,90,94,90,4,0
9,1,145,6,1,3,3,171,6,-3,94,3.87233479996212,,0.2,0,3,6,3,6
9,1,146,3,4,5,140,102,143,-3,94,2.9086811998859,,0.2,135,140,143,5,8
9,1,147,10,3,1,91,32,89,2,96,4.01791900000535,,0.2,90,91,89,1,-1
9,1,148,3,3,0,90,117,89,1,98,2.38736669998616,,0.2,90,90,89,0,-1
9,1,149,9,4,-10,125,10,133,-8,84,3.3934305999428,,0.2,135,125,133,-10,-2
9,1,150,4,3,7,97,39,101,-4,92,4.06016230001114,,0.2,90,97,101,7,11
9,1,151,2,4,9,144,25,150,-6,88,4.16935549979098,,0.2,135,144,150,9,15
9,1,152,6,1,-8,172,128,167,5,90,3.35713970009238,,0.2,0,-8,-13,-8,-13
9,1,153,7,4,2,137,21,144,-7,86,3.4784572001081,,0.2,135,137,144,2,9
9,1,154,5,1,-5,175,154,172,3,94,2.32091180002317,,0.2,0,-5,-8,-5,-8
9,1,155,5,4,-7,128,45,124,4,92,4.20517780003138,,0.2,135,128,124,-7,-11
9,1,156,2,3,10,100,83,106,-6,88,2.89669470000081,,0.2,90,100,106,10,16
9,1,157,10,4,1,136,23,134,2,96,3.41778550017625,,0.2,135,136,134,1,-1
9,1,158,9,1,-7,173,50,168,5,90,3.30830959999003,,0.2,0,-7,-12,-7,-12
9,1,159,9,4,-3,132,83,132,0,100,3.21148720011115,,0.2,135,132,132,-3,-3
9,1,160,5,1,-2,178,129,177,1,98,4.19332640012726,,0.2,0,-2,-3,-2,-3
10,1,1,4,1,-5,175,148,164,11,78,3.40622400003485,,0.2,0,-5,-16,-5,-16
10,1,2,3,4,10,145,93,146,-1,98,3.16277289995924,,0.2,135,145,146,10,11
10,1,3,1,2,0,45,65,65,-20,60,1.07878749980591,,0.2,45,45,65,0,20
10,1,4,10,3,-1,89,76,84,5,90,4.43574300012551,,0.2,90,89,84,-1,-6
10,1,5,9,2,-6,39,157,57,-18,64,4.24181500007398,,0.2,45,39,57,-6,12
10,1,6,3,4,-2,133,24,132,1,98,4.18152219988406,,0.2,135,133,132,-2,-3
10,1,8,7,1,-6,174,124,162,12,76,3.5933118998073,,0.2,0,-6,-18,-6,-18
10,1,9,7,3,6,96,151,99,-3,94,2.62438009981997,,0.2,90,96,99,6,9
10,1,10,7,2,-6,39,43,46,-7,86,2.14562470000237,,0.2,45,39,46,-6,1
10,1,11,6,1,9,9,7,15,-6,88,1.81152890017256,,0.2,0,9,15,9,15
10,1,12,5,1,9,9,150,16,-7,86,2.93295920011587,,0.2,0,9,16,9,16
10,1,13,9,2,9,54,27,63,-9,82,4.4294847000856,,0.2,45,54,63,9,18
10,1,15,8,2,5,50,171,52,-2,96,2.02381739998236,,0.2,45,50,52,5,7
10,1,16,4,3,4,94,13,109,-15,70,3.3208945998922,,0.2,90,94,109,4,19
10,1,17,5,3,-1,89,95,84,5,90,2.73905860004015,,0.2,90,89,84,-1,-6
10,1,18,1,4,-4,131,30,134,-3,94,3.32037520012818,,0.2,135,131,134,-4,-1
10,1,19,2,3,9,99,89,121,-22,56,1.84820380015299,,0.2,90,99,121,9,31
10,1,20,5,2,-6,39,133,40,-1,98,3.74484600010328,,0.2,45,39,40,-6,-5
10,1,21,6,4,1,136,43,115,21,58,3.41742269997485,,0.2,135,136,115,1,-20
10,1,22,2,4,-6,129,80,118,11,78,3.28463909984566,,0.2,135,129,118,-6,-17
10,1,23,6,2,4,49,173,51,-2,96,3.64749849983491,,0.2,45,49,51,4,6
10,1,24,2,1,6,6,150,10,-4,92,2.99374579987489,,0.2,0,6,10,6,10
10,1,25,9,1,8,8,154,16,-8,84,3.81156419985928,,0.2,0,8,16,8,16
10,1,27,1,4,-1,134,142,134,0,100,1.5632532001473,,0.2,135,134,134,-1,-1
10,1,28,9,2,3,48,15,56,-8,84,3.09658450004645,,0.2,45,48,56,3,11
10,1,29,5,2,4,49,19,55,-6,88,2.29019329999574,,0.2,45,49,55,4,10
10,1,30,3,2,7,52,8,58,-6,88,1.86067560012452,,0.2,45,52,58,7,13
10,1,31,4,2,7,52,55,55,-3,94,0.775710799964145,,0.2,45,52,55,7,10
10,1,32,8,1,-4,176,80,169,7,86,2.82968300022185,,0.2,0,-4,-11,-4,-11
10,1,33,2,2,5,50,84,51,-1,98,3.25996870012023,,0.2,45,50,51,5,6
10,1,34,2,2,-8,37,19,54,-17,66,3.21144119999371,,0.2,45,37,54,-8,9
10,1,35,2,3,5,95,101,101,-6,88,0.951406199950725,,0.2,90,95,101,5,11
10,1,36,10,1,5,5,97,16,-11,78,2.80542059987783,,0.2,0,5,16,5,16
10,1,37,2,4,7,142,126,134,8,84,2.78144629998133,,0.2,135,142,134,7,-1
10,1,38,4,3,-10,80,57,78,2,96,1.82426789985038,,0.2,90,80,78,-10,-12
10,1,39,1,1,7,7,71,11,-4,92,3.19358569988981,,0.2,0,7,11,7,11
10,1,40,10,2,6,51,143,53,-2,96,3.41180579992943,,0.2,45,51,53,6,8
10,1,41,3,3,10,100,19,109,-9,82,2.56911439984106,,0.2,90,100,109,10,19
10,1,42,8,3,-3,87,9,80,7,86,3.84814410004765,,0.2,90,87,80,-3,-10
10,1,43,5,1,-5,175,86,178,-3,94,4.45412210002542,,0.2,0,-5,-2,-5,-2
10,1,44,9,3,4,94,103,94,0,100,1.64864249993116,,0.2,90,94,94,4,4
10,1,45,8,4,-8,127,4,118,9,82,3.64213890000246,,0.2,135,127,118,-8,-17
10,1,46,10,1,-8,172,36,174,-2,96,2.52689229999669,,0.2,0,-8,-6,-8,-6
10,1,47,7,4,10,145,26,146,-1,98,1.93337240000255,,0.2,135,145,146,10,11
10,1,48,6,2,-1,44,14,55,-11,78,1.56331879994832,,0.2,45,44,55,-1,10
10,1,49,8,2,9,54,110,57,-3,94,1.75738930003718,,0.2,45,54,57,9,12
10,1,50,4,1,2,2,141,17,-15,70,1.93309710011818,,0.2,0,2,17,2,17
10,1,51,9,2,-9,36,156,36,0,100,1.4787512999028,,0.2,45,36,36,-9,-9
10,1,52,5,4,4,139,48,142,-3,94,2.59350139996968,,0.2,135,139,142,4,7
10,1,53,8,4,-3,132,159,139,-7,86,1.3995804998558,,0.2,135,132,139,-3,4
10,1,54,8,3,0,90,39,84,6,88,2.31492280005477,,0.2,90,90,84,0,-6
10,1,55,6,4,-1,134,137,137,-3,94,0.799384200014174,,0.2,135,134,137,-1,2
10,1,56,9,3,0,90,93,93,-3,94,1.0178559999913,,0.2,90,90,93,0,3
10,1,57,3,3,-6,84,126,83,1,98,3.38726789993234,,0.2,90,84,83,-6,-7
10,1,58,6,3,-1,89,138,87,2,96,1.76955169998109,,0.2,90,89,87,-1,-3
10,1,59,4,4,8,143,38,137,6,88,3.05973499990068,,0.2,135,143,137,8,2
10,1,60,1,3,-7,83,125,76,7,86,2.39951079990715,,0.2,90,83,76,-7,-14
10,1,61,1,1,-6,174,159,167,7,86,0.957789600128308,,0.2,0,-6,-13,-6,-13
10,1,62,8,1,-6,174,30,168,6,88,1.71485190000385,,0.2,0,-6,-12,-6,-12
10,1,63,1,4,8,143,20,149,-6,88,1.54574660002254,,0.2,135,143,149,8,14
10,1,64,3,1,-9,171,156,166,5,90,0.866593100130558,,0.2,0,-9,-14,-9,-14
10,1,65,5,4,10,145,47,149,-4,92,2.76316599990241,,0.2,135,145,149,10,14
10,1,66,2,2,-5,40,72,54,-14,72,2.60583030013368,,0.2,45,40,54,-5,9
10,1,67,1,3,3,93,116,90,3,94,2.04820910003036,,0.2,90,93,90,3,0
10,1,68,1,2,4,49,123,56,-7,86,2.6785883998964,,0.2,45,49,56,4,11
10,1,69,7,2,-9,36,179,40,-4,92,2.22997740004212,,0.2,45,36,40,-9,-5
10,1,70,2,3,4,94,102,101,-7,86,2.06049279985018,,0.2,90,94,101,4,11
10,1,71,4,4,-9,126,40,122,4,92,2.35139299998991,,0.2,135,126,122,-9,-13
10,1,72,10,3,-2,88,145,76,12,76,3.33308439981192,,0.2,90,88,76,-2,-14
10,1,73,5,1,4,4,60,8,-4,92,2.87220239988528,,0.2,0,4,8,4,8
10,1,74,10,4,-8,127,29,132,-5,90,2.00588650000282,,0.2,135,127,132,-8,-3
10,1,75,5,2,-4,41,27,35,6,88,1.01215319987386,,0.2,45,41,35,-4,-10
10,1,76,4,3,9,99,70,110,-11,78,1.35692179994658,,0.2,90,99,110,9,20
10,1,77,8,2,1,46,34,46,0,100,0.987134700175375,,0.2,45,46,46,1,1
10,1,78,2,1,-3,177,176,176,1,98,0.733128000050783,,0.2,0,-3,-4,-3,-4
10,1,79,8,3,-2,88,95,84,4,92,3.46037659980357,,0.2,90,88,84,-2,-6
10,1,80,3,3,2,92,23,93,-1,98,2.36300199991092,,0.2,90,92,93,2,3
10,1,81,9,4,2,137,1,144,-7,86,1.32069149985909,,0.2,135,137,144,2,9
10,1,82,7,1,-7,173,52,172,1,98,1.31496759993024,,0.2,0,-7,-8,-7,-8
10,1,83,7,3,10,100,171,103,-3,94,1.65990510000847,,0.2,90,100,103,10,13
10,1,84,4,4,-8,127,73,127,0,100,1.38165779993869,,0.2,135,127,127,-8,-8
10,1,85,9,1,-8,172,29,162,10,80,1.21841760003008,,0.2,0,-8,-18,-8,-18
10,1,86,5,1,9,9,68,20,-11,78,1.43006609985605,,0.2,0,9,20,9,20
10,1,87,1,2,-2,43,38,38,5,90,0.751102100126445,,0.2,45,43,38,-2,-7
10,1,88,8,1,8,8,24,16,-8,84,1.20542780007236,,0.2,0,8,16,8,16
10,1,89,8,2,-6,39,95,49,-10,80,1.44262609980069,,0.2,45,39,49,-6,4
10,1,90,9,4,-3,132,72,130,2,96,2.2359980000183,,0.2,135,132,130,-3,-5
10,1,91,8,4,-6,129,26,134,-5,90,1.42370159993879,,0.2,135,129,134,-6,-1
10,1,92,10,2,-5,40,157,36,4,92,3.17552389996126,,0.2,45,40,36,-5,-9
10,1,93,6,2,-4,41,65,38,3,94,2.27856280002743,,0.2,45,41,38,-4,-7
10,1,94,3,1,5,5,161,14,-9,82,1.0965492001269,,0.2,0,5,14,5,14
10,1,95,6,1,-4,176,173,173,3,94,0.793878699885681,,0.2,0,-4,-7,-4,-7
10,1,96,7,2,-8,37,153,44,-7,86,1.78778770007193,,0.2,45,37,44,-8,-1
10,1,97,2,3,-8,82,97,77,5,90,2.11482920008712,,0.2,90,82,77,-8,-13
10,1,98,6,1,9,9,26,21,-12,76,0.982178800040856,,0.2,0,9,21,9,21
10,1,99,5,2,-2,43,154,42,1,98,1.99898199993186,,0.2,45,43,42,-2,-3
10,1,100,4,2,-5,40,7,40,0,100,1.13313759979792,,0.2,45,40,40,-5,-5
10,1,101,8,4,0,135,61,141,-6,88,1.49053149996325,,0.2,135,135,141,0,6
10,1,102,4,1,-1,179,121,171,8,84,2.66672249999829,,0.2,0,-1,-9,-1,-9
10,1,103,3,4,6,141,108,148,-7,86,2.79954859986901,,0.2,135,141,148,6,13
10,1,104,10,4,7,142,163,138,4,92,1.38129170006141,,0.2,135,142,138,7,3
10,1,105,2,4,-7,128,98,127,1,98,1.01772829983383,,0.2,135,128,127,-7,-8
10,1,106,5,3,-9,81,122,83,-2,96,1.51469500013627,,0.2,90,81,83,-9,-7
10,1,107,10,1,9,9,97,15,-6,88,1.75132399983704,,0.2,0,9,15,9,15
10,1,108,10,4,-8,127,173,121,6,88,2.09662429988384,,0.2,135,127,121,-8,-14
10,1,109,2,1,-7,173,51,173,0,100,1.36319810012355,,0.2,0,-7,-7,-7,-7
10,1,110,3,4,-10,125,90,125,0,100,1.14495109999552,,0.2,135,125,125,-10,-10
10,1,111,10,4,4,139,16,138,1,98,1.62379359989427,,0.2,135,139,138,4,3
10,1,112,9,1,9,9,19,19,-10,80,0.59361520013772,,0.2,0,9,19,9,19
10,1,113,9,4,-2,133,166,141,-8,84,1.44240940012969,,0.2,135,133,141,-2,6
10,1,114,5,4,-5,130,5,123,7,86,2.67829059995711,,0.2,135,130,123,-5,-12
10,1,115,6,4,3,138,146,146,-8,84,0.79342220001854,,0.2,135,138,146,3,11
10,1,116,6,3,-8,82,52,77,5,90,1.56336569995619,,0.2,90,82,77,-8,-13
10,1,117,9,1,-3,177,90,169,8,84,3.53276169998571,,0.2,0,-3,-11,-3,-11
10,1,118,7,4,9,144,168,165,-21,58,3.16277130017988,,0.2,135,144,165,9,30
10,1,119,3,1,-2,178,71,175,3,94,2.21183659997769,,0.2,0,-2,-5,-2,-5
10,1,120,6,1,-7,173,127,174,-1,98,2.04207760002464,,0.2,0,-7,-6,-7,-6
10,1,121,10,2,-4,41,117,53,-12,76,2.21205879980698,,0.2,45,41,53,-4,8
10,1,122,8,3,2,92,83,99,-7,86,1.53907699999399,,0.2,90,92,99,2,9
10,1,123,10,3,-9,81,7,84,-3,94,1.82953819981776,,0.2,90,81,84,-9,-6
10,1,124,9,3,6,96,95,101,-5,90,1.7631345000118,,0.2,90,96,101,6,11
10,1,125,7,3,0,90,48,91,-1,98,3.21165539999492,,0.2,90,90,91,0,1
10,1,126,5,3,9,99,60,101,-2,96,2.12716250005178,,0.2,90,99,101,9,11
10,1,127,2,2,8,53,76,53,0,100,2.39981540013105,,0.2,45,53,53,8,8
10,1,128,10,3,1,91,175,91,0,100,3.36903539998457,,0.2,90,91,91,1,1
10,1,129,4,2,-1,44,43,56,-12,76,2.69083079998381,,0.2,45,44,56,-1,11
10,1,130,4,4,8,143,38,131,12,76,3.00570320012048,,0.2,135,143,131,8,-4
10,1,131,7,3,4,94,76,103,-9,82,2.83012970001437,,0.2,90,94,103,4,13
10,1,132,6,4,0,135,70,130,5,90,2.53272039978765,,0.2,135,135,130,0,-5
10,1,133,2,1,7,7,7,18,-11,78,1.62389799999073,,0.2,0,7,18,7,18
10,1,134,2,4,2,137,67,127,10,80,3.92616929998621,,0.2,135,137,127,2,-8
10,1,135,1,1,9,9,96,19,-10,80,1.93915650015697,,0.2,0,9,19,9,19
10,1,136,4,2,-6,39,120,50,-11,78,1.59985120012425,,0.2,45,39,50,-6,5
10,1,137,5,3,9,99,149,116,-17,66,2.32637759996578,,0.2,90,99,116,9,26
10,1,138,4,1,4,4,10,13,-9,82,3.79903339990415,,0.2,0,4,13,4,13
10,1,139,3,2,1,46,32,49,-3,94,1.36885809991509,,0.2,45,46,49,1,4
10,1,140,7,1,-2,178,150,176,2,96,1.16896570008248,,0.2,0,-2,-4,-2,-4
10,1,141,7,4,3,138,78,142,-4,92,1.78763459995389,,0.2,135,138,142,3,7
10,1,142,4,3,10,100,138,110,-10,80,1.24212979990989,,0.2,90,100,110,10,20
10,1,143,6,2,-6,39,31,41,-2,96,0.975330100161955,,0.2,45,39,41,-6,-4
10,1,144,9,4,-2,133,111,134,-1,98,1.13329819985665,,0.2,135,133,134,-2,-1
10,1,145,6,3,3,93,41,92,1,98,1.83607520000078,,0.2,90,93,92,3,2
10,1,146,7,4,-5,130,68,121,9,82,1.61789280013181,,0.2,135,130,121,-5,-14
10,1,147,10,2,5,50,101,60,-10,80,1.37549689994194,,0.2,45,50,60,5,15
10,1,148,5,4,-6,129,91,130,-1,98,1.31491559999995,,0.2,135,129,130,-6,-5
10,1,149,3,2,-6,39,86,50,-11,78,1.03623880003579,,0.2,45,39,50,-6,5
10,1,150,1,1,0,0,75,5,-5,90,1.53327249991708,,0.2,0,0,5,0,5
10,1,151,1,3,2,92,171,95,-3,94,1.41183779994026,,0.2,90,92,95,2,5
10,1,152,1,2,5,50,77,61,-11,78,1.26644030003808,,0.2,45,50,61,5,16
10,1,153,1,3,-1,89,43,82,7,86,1.0544001001399,,0.2,90,89,82,-1,-8
10,1,154,7,1,1,1,25,17,-16,68,2.69593399995938,,0.2,0,1,17,1,17
10,1,155,7,2,4,49,136,64,-15,70,1.95114720007405,,0.2,45,49,64,4,19
10,1,156,1,4,-3,132,59,146,-14,72,2.76972009986639,,0.2,135,132,146,-3,11
10,1,157,3,3,-8,82,101,76,6,88,1.03654469992034,,0.2,90,82,76,-8,-14
10,1,158,3,2,-1,44,69,62,-18,64,2.47240149998106,,0.2,45,44,62,-1,17
10,1,159,8,1,-4,176,73,164,12,76,3.02354450011626,,0.2,0,-4,-16,-4,-16
10,1,160,3,1,10,10,142,12,-2,96,1.49072930007242,,0.2,0,10,12,10,12
11,1,1,8,4,-2,133,119,119,14,72,1.49739469494671,,0.2,135,133,119,-2,-16
11,1,2,1,1,-6,174,46,165,9,82,1.85362846998032,,0.2,0,-6,-15,-6,-15
11,1,3,4,1,-7,173,123,164,9,82,1.84716189198662,,0.2,0,-7,-16,-7,-16
11,1,4,6,4,-4,131,25,127,4,92,1.92246463091578,,0.2,135,131,127,-4,-8
11,1,5,8,3,2,92,175,89,3,94,2.42017542698886,,0.2,90,92,89,2,-1
11,1,6,8,1,6,6,135,9,-3,94,2.19853357190732,,0.2,0,6,9,6,9
11,1,7,7,4,5,140,178,135,5,90,1.38077708904166,,0.2,135,140,135,5,0
11,1,8,9,2,8,53,73,59,-6,88,1.726390813943,,0.2,45,53,59,8,14
11,1,9,5,1,-7,173,81,162,11,78,2.47083978401497,,0.2,0,-7,-18,-7,-18
11,1,10,8,2,1,46,159,45,1,98,1.8304499629885,,0.2,45,46,45,1,0
11,1,11,10,4,8,143,122,128,15,70,2.16510932205711,,0.2,135,143,128,8,-7
11,1,12,7,4,5,140,13,137,3,94,1.86531393998303,,0.2,135,140,137,5,2
11,1,13,2,3,-2,88,113,83,5,90,2.24826419493183,,0.2,90,88,83,-2,-7
11,1,14,4,4,9,144,112,136,8,84,1.26572878297884,,0.2,135,144,136,9,1
11,1,15,9,4,7,142,72,141,1,98,3.53021579701453,,0.2,135,142,141,7,6
11,1,16,2,4,6,141,97,140,1,98,1.84985540900379,,0.2,135,141,140,6,5
11,1,17,2,1,7,7,39,7,0,100,1.73148163990118,,0.2,0,7,7,7,7
11,1,18,5,3,0,90,64,92,-2,96,2.36447391100228,,0.2,90,90,92,0,2
11,1,19,8,3,7,97,86,105,-8,84,0.981991342967376,,0.2,90,97,105,7,15
11,1,20,1,3,-6,84,9,84,0,100,2.52938647801057,,0.2,90,84,84,-6,-6
11,1,21,10,3,4,94,111,97,-3,94,1.79628302704077,,0.2,90,94,97,4,7
11,1,22,6,1,-5,175,17,168,7,86,1.20509624097031,,0.2,0,-5,-12,-5,-12
11,1,23,2,2,9,54,89,65,-11,78,1.31552381999791,,0.2,45,54,65,9,20
11,1,24,2,2,1,46,171,47,-1,98,2.21465068904217,,0.2,45,46,47,1,2
11,1,25,4,3,-6,84,94,81,3,94,1.133951789001,,0.2,90,84,81,-6,-9
11,1,26,6,1,-6,174,131,161,13,74,1.66447832295671,,0.2,0,-6,-19,-6,-19
11,1,27,2,4,-3,132,180,128,4,92,1.84649402310606,,0.2,135,132,128,-3,-7
11,1,28,9,1,-9,171,163,170,1,98,0.91539251501672,,0.2,0,-9,-10,-9,-10
11,1,29,6,2,4,49,10,54,-5,90,2.29796948900912,,0.2,45,49,54,4,9
11,1,30,2,1,-2,178,15,164,14,72,1.83162338403054,,0.2,0,-2,-16,-2,-16
11,1,31,3,1,0,0,114,178,2,96,2.16739120590501,,0.2,0,0,-2,0,-2
11,1,32,1,2,-6,39,14,34,5,90,1.56548631598707,,0.2,45,39,34,-6,-11
11,1,33,3,1,-4,176,108,162,14,72,1.88237792509608,,0.2,0,-4,-18,-4,-18
11,1,34,3,3,2,92,92,92,0,100,0.84759026102256,,0.2,90,92,92,2,2
11,1,35,6,3,1,91,49,97,-6,88,1.68095707905013,,0.2,90,91,97,1,7
11,1,36,4,1,-5,175,90,168,7,86,3.61507876799442,,0.2,0,-5,-12,-5,-12
11,1,37,5,2,8,53,17,53,0,100,1.61849768797401,,0.2,45,53,53,8,8
11,1,38,1,2,-9,36,70,51,-15,70,1.28278956189752,,0.2,45,36,51,-9,6
11,1,39,3,2,-1,44,158,34,10,80,2.943878574064,,0.2,45,44,34,-1,-11
11,1,40,4,2,5,50,78,54,-4,92,1.63317933294456,,0.2,45,50,54,5,9
11,1,41,4,3,-6,84,5,81,3,94,2.43929262494203,,0.2,90,84,81,-6,-9
11,1,42,6,2,-7,38,26,47,-9,82,1.22148921294138,,0.2,45,38,47,-7,2
11,1,43,10,4,-3,132,124,131,1,98,1.04829910595436,,0.2,135,132,131,-3,-4
11,1,44,5,4,7,142,62,137,5,90,3.71557610598393,,0.2,135,142,137,7,2
11,1,45,7,3,2,92,167,98,-6,88,3.01413515699096,,0.2,90,92,98,2,8
11,1,46,1,1,2,2,76,6,-4,92,2.21040237299167,,0.2,0,2,6,2,6
11,1,47,5,2,4,49,27,37,12,76,1.18180238897912,,0.2,45,49,37,4,-8
11,1,48,1,4,-6,129,94,124,5,90,2.69929726107512,,0.2,135,129,124,-6,-11
11,1,49,10,2,-1,44,86,48,-4,92,1.66434144298546,,0.2,45,44,48,-1,3
11,1,50,9,3,4,94,83,96,-2,96,1.95015988801606,,0.2,90,94,96,4,6
11,1,51,9,4,6,141,156,137,4,92,1.18160415091552,,0.2,135,141,137,6,2
11,1,52,5,1,-4,176,36,163,13,74,2.61589968402404,,0.2,0,-4,-17,-4,-17
11,1,53,7,1,-2,178,85,173,5,90,2.51430643897038,,0.2,0,-2,-7,-2,-7
11,1,54,6,2,1,46,174,44,2,96,1.76526350097265,,0.2,45,46,44,1,-1
11,1,55,7,2,10,55,66,57,-2,96,1.33192443090957,,0.2,45,55,57,10,12
11,1,56,3,2,0,45,107,43,2,96,2.11835280095693,,0.2,45,45,43,0,-2
11,1,57,1,4,3,138,25,141,-3,94,1.93228550499771,,0.2,135,138,141,3,6
11,1,58,6,3,-1,89,176,78,11,78,2.41515510005411,,0.2,90,89,78,-1,-12
11,1,59,10,2,-10,35,48,41,-6,88,0.964353365940042,,0.2,45,35,41,-10,-4
11,1,60,6,1,-3,177,180,177,0,100,0.980704235029407,,0.2,0,-3,-3,-3,-3
11,1,61,5,3,-5,85,44,86,-1,98,2.12927938997746,,0.2,90,85,86,-5,-4
11,1,62,3,3,2,92,50,99,-7,86,1.59751517896075,,0.2,90,92,99,2,9
11,1,63,2,3,3,93,161,100,-7,86,3.998829699005,,0.2,90,93,100,3,10
11,1,64,9,2,9,54,148,64,-10,80,3.27961446903646,,0.2,45,54,64,9,19
11,1,65,3,4,-3,132,62,117,15,70,3.4595231229905,,0.2,135,132,117,-3,-18
11,1,66,7,3,4,94,116,98,-4,92,1.46309900097549,,0.2,90,94,98,4,8
11,1,67,6,2,-5,40,160,46,-6,88,2.21444933791645,,0.2,45,40,46,-5,1
11,1,68,8,1,2,2,91,10,-8,84,2.3807372560259,,0.2,0,2,10,2,10
11,1,69,6,3,-9,81,97,79,2,96,2.05009020201396,,0.2,90,81,79,-9,-11
11,1,70,8,3,-3,87,79,79,8,84,0.682182515971363,,0.2,90,87,79,-3,-11
11,1,71,10,4,4,139,110,131,8,84,1.33229681605007,,0.2,135,139,131,4,-4
11,1,72,5,3,-7,83,111,82,1,98,1.44808452297002,,0.2,90,83,82,-7,-8
11,1,73,8,2,4,49,134,71,-22,56,2.7555776250083,,0.2,45,49,71,4,26
11,1,74,2,1,9,9,48,19,-10,80,1.91379694303032,,0.2,0,9,19,9,19
11,1,75,3,2,7,52,52,52,0,100,1.40325858804863,,0.2,45,52,52,7,7
11,1,76,10,4,1,136,100,125,11,78,1.59944764792453,,0.2,135,136,125,1,-10
11,1,77,7,3,0,90,27,95,-5,90,3.04873582103755,,0.2,90,90,95,0,5
11,1,78,9,3,5,95,151,95,0,100,2.88124960404821,,0.2,90,95,95,5,5
11,1,79,5,2,1,46,116,66,-20,60,2.58237954496872,,0.2,45,46,66,1,21
11,1,80,5,4,1,136,7,129,7,86,1.97945476695895,,0.2,135,136,129,1,-6
11,1,81,3,1,2,2,142,5,-3,94,1.79963138198946,,0.2,0,2,5,2,5
11,1,82,2,2,10,55,159,54,1,98,1.91523476503789,,0.2,45,55,54,10,9
11,1,83,3,4,-9,126,75,125,1,98,3.61572012107354,,0.2,135,126,125,-9,-10
11,1,84,9,4,-2,133,112,126,7,86,1.14829808904324,,0.2,135,133,126,-2,-9
11,1,85,10,2,2,47,173,56,-9,82,1.83405712898821,,0.2,45,47,56,2,11
11,1,86,2,3,1,91,81,101,-10,80,1.91661029995885,,0.2,90,91,101,1,11
11,1,87,5,2,5,50,86,60,-10,80,1.5477166910423,,0.2,45,50,60,5,15
11,1,88,4,3,-1,89,47,84,5,90,1.86816623294726,,0.2,90,89,84,-1,-6
11,1,89,5,1,-5,175,35,170,5,90,2.1489784369478,,0.2,0,-5,-10,-5,-10
11,1,90,9,3,3,93,80,96,-3,94,1.09865900804289,,0.2,90,93,96,3,6
11,1,91,7,4,4,139,171,139,0,100,1.56273088697344,,0.2,135,139,139,4,4
11,1,92,4,3,-6,84,132,85,-1,98,2.24717482097913,,0.2,90,84,85,-6,-5
11,1,93,8,2,4,49,6,53,-4,92,1.82053568901028,,0.2,45,49,53,4,8
11,1,94,9,1,-8,172,131,163,9,82,1.53258308803197,,0.2,0,-8,-17,-8,-17
11,1,95,10,1,-10,170,53,169,1,98,2.74841431598179,,0.2,0,-10,-11,-10,-11
11,1,96,9,4,8,143,75,136,7,86,2.49522637296468,,0.2,135,143,136,8,1
11,1,97,9,3,-8,82,8,81,1,98,2.11259413498919,,0.2,90,82,81,-8,-9
11,1,98,1,3,7,97,158,104,-7,86,1.71415916096885,,0.2,90,97,104,7,14
11,1,99,7,2,5,50,41,49,1,98,0.964596312958747,,0.2,45,50,49,5,4
11,1,100,5,1,8,8,0,14,-6,88,1.61846081307158,,0.2,0,8,14,8,14
11,1,101,4,2,1,46,157,47,-1,98,2.04895476996899,,0.2,45,46,47,1,2
11,1,102,10,3,2,92,10,104,-12,76,2.82955073995981,,0.2,90,92,104,2,14
11,1,103,2,4,-4,131,138,124,7,86,1.33019697200507,,0.2,135,131,124,-4,-11
11,1,104,10,1,4,4,138,10,-6,88,3.55691598798148,,0.2,0,4,10,4,10
11,1,105,10,2,7,52,14,41,11,78,1.24838809203357,,0.2,45,52,41,7,-4
11,1,106,8,4,-8,127,124,124,3,94,0.768903400981799,,0.2,135,127,124,-8,-11
11,1,107,1,3,8,98,167,110,-12,76,1.95074856991414,,0.2,90,98,110,8,20
11,1,108,5,4,10,145,134,134,11,78,0.613815929973498,,0.2,135,145,134,10,-1
11,1,109,7,2,6,51,55,51,0,100,1.42860104702413,,0.2,45,51,51,6,6
11,1,110,9,1,-9,171,62,162,9,82,2.9147756769089,,0.2,0,-9,-18,-9,-18
11,1,111,7,1,2,2,131,10,-8,84,1.98315828095656,,0.2,0,2,10,2,10
11,1,112,1,4,-10,125,30,112,13,74,2.91416990803555,,0.2,135,125,112,-10,-23
11,1,113,8,4,-9,126,110,124,2,96,1.11736956599634,,0.2,135,126,124,-9,-11
11,1,114,8,1,1,1,159,3,-2,96,2.01539244002197,,0.2,0,1,3,1,3
11,1,115,10,1,-5,175,46,171,4,92,2.32848224998452,,0.2,0,-5,-9,-5,-9
11,1,116,3,4,-7,128,104,115,13,74,1.41427069203928,,0.2,135,128,115,-7,-20
11,1,117,3,4,6,141,79,141,0,100,2.27278659399599,,0.2,135,141,141,6,6
11,1,118,8,4,-7,128,155,134,-6,88,1.38211477303412,,0.2,135,128,134,-7,-1
11,1,119,7,1,5,5,100,15,-10,80,2.71845638507511,,0.2,0,5,15,5,15
11,1,120,10,3,-1,89,121,85,4,92,1.59968784102239,,0.2,90,89,85,-1,-5
11,1,121,6,4,8,143,71,139,4,92,2.16495493100956,,0.2,135,143,139,8,4
11,1,122,6,1,5,5,124,11,-6,88,1.99330508103594,,0.2,0,5,11,5,11
11,1,123,9,2,3,48,58,48,0,100,0.959202956990339,,0.2,45,48,48,3,3
11,1,124,3,1,-7,173,150,161,12,76,1.23080311191734,,0.2,0,-7,-19,-7,-19
11,1,125,3,2,-6,39,93,44,-5,90,2.36878567107487,,0.2,45,39,44,-6,-1
11,1,126,6,4,4,139,48,148,-9,82,2.46736543590669,,0.2,135,139,148,4,13
11,1,127,4,4,6,141,144,144,-3,94,0.631376303033903,,0.2,135,141,144,6,9
11,1,128,7,3,1,91,161,93,-2,96,2.34728412004188,,0.2,90,91,93,1,3
11,1,129,10,3,-2,88,20,84,4,92,2.13109156303108,,0.2,90,88,84,-2,-6
11,1,130,5,3,-5,85,17,84,1,98,2.03255579608958,,0.2,90,85,84,-5,-6
11,1,131,3,3,-10,80,9,82,-2,96,2.01557452499401,,0.2,90,80,82,-10,-8
11,1,132,1,2,8,53,78,64,-11,78,1.36803106195293,,0.2,45,53,64,8,19
11,1,133,1,1,-2,178,73,165,13,74,2.3152050699573,,0.2,0,-2,-15,-2,-15
11,1,134,2,4,-2,133,142,142,-9,82,0.715265720966272,,0.2,135,133,142,-2,7
11,1,135,7,2,-9,36,161,33,3,94,1.83124509407207,,0.2,45,36,33,-9,-12
11,1,136,4,1,-2,178,53,166,12,76,2.01687007001601,,0.2,0,-2,-14,-2,-14
11,1,137,7,4,8,143,171,132,11,78,1.58669834793545,,0.2,135,143,132,8,-3
11,1,138,1,4,-2,133,89,123,10,80,1.8847049070755,,0.2,135,133,123,-2,-12
11,1,139,4,4,-5,130,5,124,6,88,2.53115297399927,,0.2,135,130,124,-5,-11
11,1,140,10,1,-5,175,155,175,0,100,1.44506816996727,,0.2,0,-5,-5,-5,-5
11,1,141,4,2,1,46,116,64,-18,64,2.77996466099285,,0.2,45,46,64,1,19
11,1,142,8,3,0,90,94,88,2,96,2.19821226608474,,0.2,90,90,88,0,-2
11,1,143,4,2,-7,38,15,45,-7,86,1.44926892407238,,0.2,45,38,45,-7,0
11,1,144,1,3,9,99,122,97,2,96,1.53305294993334,,0.2,90,99,97,9,7
11,1,145,6,4,-9,126,56,121,5,90,2.66623125004116,,0.2,135,126,121,-9,-14
11,1,146,8,1,0,0,48,21,-21,58,1.74871833110228,,0.2,0,0,21,0,21
11,1,147,5,4,-3,132,108,132,0,100,1.4830911239842,,0.2,135,132,132,-3,-3
11,1,148,2,2,-6,39,10,42,-3,94,1.24776619195472,,0.2,45,39,42,-6,-3
11,1,149,2,1,8,8,17,12,-4,92,0.897280156961642,,0.2,0,8,12,8,12
11,1,150,4,4,6,141,37,139,2,96,2.16628237999976,,0.2,135,141,139,6,4
11,1,151,9,2,5,50,84,69,-19,62,1.99821576394606,,0.2,45,50,69,5,24
11,1,152,1,1,3,3,53,172,11,78,1.8638182899449,,0.2,0,3,-8,3,-8
11,1,153,4,1,-5,175,46,175,0,100,2.69492895097937,,0.2,0,-5,-5,-5,-5
11,1,154,6,3,-1,89,51,85,4,92,1.6643335709814,,0.2,90,89,85,-1,-5
11,1,155,9,1,3,3,72,178,5,90,2.98074539809022,,0.2,0,3,-2,3,-2
11,1,156,1,2,2,47,12,43,4,92,1.41960039699916,,0.2,45,47,43,2,-2
11,1,157,3,3,-7,83,116,82,1,98,2.40189884300344,,0.2,90,83,82,-7,-8
11,1,158,7,1,5,5,59,7,-2,96,2.46643801103346,,0.2,0,5,7,5,7
11,1,159,8,2,-9,36,47,47,-11,78,1.09797187196091,,0.2,45,36,47,-9,2
11,1,160,2,3,9,99,121,103,-4,92,1.41476313991006,,0.2,90,99,103,9,13
12,1,1,4,1,-5,175,148,177,-2,96,3.60057120001875,,0.2,0,-5,-3,-5,-3
12,1,3,1,2,0,45,65,65,-20,60,0.74532589991577,,0.2,45,45,65,0,20
12,1,5,9,2,-6,39,157,32,7,86,1.53991669998504,,0.2,45,39,32,-6,-13
12,1,6,3,4,-2,133,24,119,14,72,2.1995122001972,,0.2,135,133,119,-2,-16
12,1,8,7,1,-6,174,124,152,22,56,4.18157829996198,,0.2,0,-6,-28,-6,-28
12,1,10,7,2,-6,39,43,43,-4,92,0.672629100037739,,0.2,45,39,43,-6,-2
12,1,11,6,1,9,9,7,7,2,96,0.769874500110745,,0.2,0,9,7,9,7
12,1,12,5,1,9,9,150,17,-8,84,2.5150800999254,,0.2,0,9,17,9,17
12,1,14,6,3,-4,86,176,82,4,92,2.58821459999308,,0.2,90,86,82,-4,-8
12,1,16,4,3,4,94,13,101,-7,86,3.81134100002237,,0.2,90,94,101,4,11
12,1,18,1,4,-4,131,30,111,20,60,2.1268428999465,,0.2,135,131,111,-4,-24
12,1,19,2,3,9,99,89,104,-5,90,0.87257989984937,,0.2,90,99,104,9,14
12,1,21,6,4,1,136,43,131,5,90,2.2661907998845,,0.2,135,136,131,1,-4
12,1,22,2,4,-6,129,80,118,11,78,1.81210380000994,,0.2,135,129,118,-6,-17
12,1,26,9,3,-7,83,112,82,1,98,2.47902440000325,,0.2,90,83,82,-7,-8
12,1,27,1,4,-1,134,142,135,-1,98,1.78175910003483,,0.2,135,134,135,-1,0
12,1,28,9,2,3,48,15,64,-16,68,1.76364640006796,,0.2,45,48,64,3,19
12,1,29,5,2,4,49,19,48,1,98,2.13321050000377,,0.2,45,49,48,4,3
12,1,30,3,2,7,52,8,55,-3,94,1.37604400003329,,0.2,45,52,55,7,10
12,1,31,4,2,7,52,55,55,-3,94,0.538937699981034,,0.2,45,52,55,7,10
12,1,32,8,1,-4,176,80,175,1,98,3.89672879991122,,0.2,0,-4,-5,-4,-5
12,1,33,2,2,5,50,84,44,6,88,2.07216489990242,,0.2,45,50,44,5,-1
12,1,34,2,2,-8,37,19,19,18,64,0.884758099913597,,0.2,45,37,19,-8,-26
12,1,35,2,3,5,95,101,101,-6,88,0.630707900039852,,0.2,90,95,101,5,11
12,1,36,10,1,5,5,97,4,1,98,4.26629390008748,,0.2,0,5,4,5,4
12,1,37,2,4,7,142,126,126,16,68,0.793959599919617,,0.2,135,142,126,7,-9
12,1,38,4,3,-10,80,57,63,17,66,1.98746219999157,,0.2,90,80,63,-10,-27
12,1,40,10,2,6,51,143,35,16,68,2.63561009988189,,0.2,45,51,35,6,-10
12,1,41,3,3,10,100,19,106,-6,88,2.53942540008575,,0.2,90,100,106,10,16
12,1,43,5,1,-5,175,86,175,0,100,1.88501480012201,,0.2,0,-5,-5,-5,-5
12,1,44,9,3,4,94,103,91,3,94,2.30760950013064,,0.2,90,94,91,4,1
12,1,45,8,4,-8,127,4,117,10,80,2.12108640000224,,0.2,135,127,117,-8,-18
12,1,47,7,4,10,145,26,159,-14,72,3.2601931001991,,0.2,135,145,159,10,24
12,1,48,6,2,-1,44,14,56,-12,76,2.77565239998512,,0.2,45,44,56,-1,11
12,1,49,8,2,9,54,110,54,0,100,3.85991680016741,,0.2,45,54,54,9,9
12,1,50,4,1,2,2,141,0,2,96,1.50899240002036,,0.2,0,2,0,2,0
12,1,51,9,2,-9,36,156,19,17,66,3.09624179988168,,0.2,45,36,19,-9,-26
12,1,53,8,4,-3,132,159,142,-10,80,1.43016820005141,,0.2,135,132,142,-3,7
12,1,55,6,4,-1,134,137,137,-3,94,1.0725360000506,,0.2,135,134,137,-1,2
12,1,56,9,3,0,90,93,87,3,94,2.91419819998555,,0.2,90,90,87,0,-3
12,1,57,3,3,-6,84,126,85,-1,98,2.43565199989825,,0.2,90,84,85,-6,-5
12,1,59,4,4,8,143,38,140,3,94,3.45379840000533,,0.2,135,143,140,8,5
12,1,60,1,3,-7,83,125,80,3,94,1.6176386999432,,0.2,90,83,80,-7,-10
12,1,61,1,1,-6,174,159,159,15,70,0.702898600138724,,0.2,0,-6,-21,-6,-21
12,1,62,8,1,-6,174,30,164,10,80,3.66048890003003,,0.2,0,-6,-16,-6,-16
12,1,64,3,1,-9,171,156,156,15,70,0.59403089992702,,0.2,0,-9,-24,-9,-24
12,1,65,5,4,10,145,47,154,-9,82,3.82993789995089,,0.2,135,145,154,10,19
12,1,66,2,2,-5,40,72,30,10,80,3.87825360009447,,0.2,45,40,30,-5,-15
12,1,67,1,3,3,93,116,89,4,92,3.46014620014466,,0.2,90,93,89,3,-1
12,1,69,7,2,-9,36,179,40,-4,92,3.10279859998263,,0.2,45,36,40,-9,-5
12,1,70,2,3,4,94,102,102,-8,84,0.896714800037444,,0.2,90,94,102,4,12
12,1,71,4,4,-9,126,40,116,10,80,2.82387159997597,,0.2,135,126,116,-9,-19
12,1,74,10,4,-8,127,29,111,16,68,1.69056590017863,,0.2,135,127,111,-8,-24
12,1,76,4,3,9,99,70,106,-7,86,1.82397940009832,,0.2,90,99,106,9,16
12,1,77,8,2,1,46,34,53,-7,86,1.15773149998859,,0.2,45,46,53,1,8
12,1,78,2,1,-3,177,176,176,1,98,0.509106999961659,,0.2,0,-3,-4,-3,-4
12,1,79,8,3,-2,88,95,71,17,66,3.34478239994496,,0.2,90,88,71,-2,-19
12,1,80,3,3,2,92,23,92,0,100,3.15695780003443,,0.2,90,92,92,2,2
12,1,81,9,4,2,137,1,130,7,86,1.79398180008866,,0.2,135,137,130,2,-5
12,1,82,7,1,-7,173,52,164,9,82,2.79972469992936,,0.2,0,-7,-16,-7,-16
12,1,83,7,3,10,100,171,95,5,90,2.44823460001498,,0.2,90,100,95,10,5
12,1,84,4,4,-8,127,73,109,18,64,1.75135149993002,,0.2,135,127,109,-8,-26
12,1,85,9,1,-8,172,29,150,22,56,2.98121260013431,,0.2,0,-8,-30,-8,-30
12,1,86,5,1,9,9,68,15,-6,88,2.86053929990157,,0.2,0,9,15,9,15
12,1,87,1,2,-2,43,38,54,-11,78,2.07264699996449,,0.2,45,43,54,-2,9
12,1,88,8,1,8,8,24,16,-8,84,2.8117681001313,,0.2,0,8,16,8,16
12,1,89,8,2,-6,39,95,52,-13,74,1.55745870014653,,0.2,45,39,52,-6,7
12,1,90,9,4,-3,132,72,118,14,72,1.73325000004843,,0.2,135,132,118,-3,-17
12,1,91,8,4,-6,129,26,113,16,68,3.56928290007636,,0.2,135,129,113,-6,-22
12,1,94,3,1,5,5,161,10,-5,90,2.44219650002196,,0.2,0,5,10,5,10
12,1,95,6,1,-4,176,173,176,0,100,4.19897450017743,,0.2,0,-4,-4,-4,-4
12,1,97,2,3,-8,82,97,80,2,96,1.69044879986905,,0.2,90,82,80,-8,-10
12,1,98,6,1,9,9,26,9,0,100,1.7572182000149,,0.2,0,9,9,9,9
12,1,99,5,2,-2,43,154,58,-15,70,3.3807898000814,,0.2,45,43,58,-2,13
12,1,101,8,4,0,135,61,121,14,72,1.65420240000822,,0.2,135,135,121,0,-14
12,1,102,4,1,-1,179,121,166,13,74,2.84219699981622,,0.2,0,-1,-14,-1,-14
12,1,103,3,4,6,141,108,154,-13,74,2.10903779999353,,0.2,135,141,154,6,19
12,1,104,10,4,7,142,163,150,-8,84,1.89062860002741,,0.2,135,142,150,7,15
12,1,105,2,4,-7,128,98,132,-4,92,2.03594650002196,,0.2,135,128,132,-7,-3
12,1,106,5,3,-9,81,122,78,3,94,1.64870190015063,,0.2,90,81,78,-9,-12
12,1,107,10,1,9,9,97,13,-4,92,2.81806690013036,,0.2,0,9,13,9,13
12,1,109,2,1,-7,173,51,167,6,88,3.62364739994518,,0.2,0,-7,-13,-7,-13
12,1,110,3,4,-10,125,90,128,-3,94,1.2905145001132,,0.2,135,125,128,-10,-7
12,1,111,10,4,4,139,16,148,-9,82,2.49030450009741,,0.2,135,139,148,4,13
12,1,112,9,1,9,9,19,19,-10,80,0.624245899962261,,0.2,0,9,19,9,19
12,1,113,9,4,-2,133,166,152,-19,62,1.53314329986461,,0.2,135,133,152,-2,17
12,1,115,6,4,3,138,146,146,-8,84,0.690713699907064,,0.2,135,138,146,3,11
12,1,116,6,3,-8,82,52,77,5,90,2.96311219991185,,0.2,90,82,77,-8,-13
12,1,117,9,1,-3,177,90,175,2,96,2.64229029999115,,0.2,0,-3,-5,-3,-5
12,1,118,7,4,9,144,168,159,-15,70,1.09088640008122,,0.2,135,144,159,9,24
12,1,119,3,1,-2,178,71,175,3,94,1.77567319991067,,0.2,0,-2,-5,-2,-5
12,1,120,6,1,-7,173,127,166,7,86,2.58732819999568,,0.2,0,-7,-14,-7,-14
12,1,122,8,3,2,92,83,104,-12,76,3.69671689998358,,0.2,90,92,104,2,14
12,1,123,10,3,-9,81,7,85,-4,92,2.70280149998143,,0.2,90,81,85,-9,-5
12,1,124,9,3,6,96,95,95,1,98,0.533416599966586,,0.2,90,96,95,6,5
12,1,125,7,3,0,90,48,90,0,100,2.99980049999431,,0.2,90,90,90,0,0
12,1,126,5,3,9,99,60,98,1,98,1.09692939999513,,0.2,90,99,98,9,8
12,1,127,2,2,8,53,76,66,-13,74,1.39415979990736,,0.2,45,53,66,8,21
12,1,128,10,3,1,91,175,93,-2,96,2.75145559990779,,0.2,90,91,93,1,3
12,1,129,4,2,-1,44,43,43,1,98,0.527251200051978,,0.2,45,44,43,-1,-2
12,1,130,4,4,8,143,38,127,16,68,1.6244487001095,,0.2,135,143,127,8,-8
12,1,131,7,3,4,94,76,98,-4,92,1.65428439993411,,0.2,90,94,98,4,8
12,1,132,6,4,0,135,70,113,22,56,1.04838649998419,,0.2,135,135,113,0,-22
12,1,133,2,1,7,7,7,7,0,100,0.660446600057185,,0.2,0,7,7,7,7
12,1,134,2,4,2,137,67,122,15,70,2.59344159998,,0.2,135,137,122,2,-13
12,1,136,4,2,-6,39,120,32,7,86,3.46038810000755,,0.2,45,39,32,-6,-13
12,1,137,5,3,9,99,149,97,2,96,1.49105100007728,,0.2,90,99,97,9,7
12,1,138,4,1,4,4,10,10,-6,88,1.20035629998893,,0.2,0,4,10,4,10
12,1,139,3,2,1,46,32,32,14,72,0.630493900040165,,0.2,45,46,32,1,-13
12,1,140,7,1,-2,178,150,176,2,96,1.64273459999822,,0.2,0,-2,-4,-2,-4
12,1,141,7,4,3,138,78,152,-14,72,2.25427650008351,,0.2,135,138,152,3,17
12,1,142,4,3,10,100,138,97,3,94,1.43605260015465,,0.2,90,100,97,10,7
12,1,143,6,2,-6,39,31,31,8,84,0.624355299863964,,0.2,45,39,31,-6,-14
12,1,144,9,4,-2,133,111,111,22,56,0.424597500124946,,0.2,135,133,111,-2,-24
12,1,145,6,3,3,93,41,93,0,100,1.9873841998633,,0.2,90,93,93,3,3
12,1,147,10,2,5,50,101,54,-4,92,1.67840860015713,,0.2,45,50,54,5,9
12,1,148,5,4,-6,129,91,118,11,78,1.93901679990813,,0.2,135,129,118,-6,-17
12,1,150,1,1,0,0,75,0,0,100,3.2663542998489,,0.2,0,0,0,0,0
12,1,151,1,3,2,92,171,100,-8,84,2.44834299990907,,0.2,90,92,100,2,10
12,1,152,1,2,5,50,77,55,-5,90,2.72673220001161,,0.2,45,50,55,5,10
12,1,153,1,3,-1,89,43,91,-2,96,2.36900450009853,,0.2,90,89,91,-1,1
12,1,154,7,1,1,1,25,179,2,96,1.58180159982294,,0.2,0,1,-1,1,-1
12,1,156,1,4,-3,132,59,119,13,74,1.32710130000487,,0.2,135,132,119,-3,-16
12,1,157,3,3,-8,82,101,71,11,78,0.86639149999246,,0.2,90,82,71,-8,-19
12,1,158,3,2,-1,44,69,43,1,98,1.21232739998959,,0.2,45,44,43,-1,-2
12,1,159,8,1,-4,176,73,0,-4,92,3.34475090005435,,0.2,0,-4,0,-4,0
12,1,160,3,1,10,10,142,6,4,92,2.31508059985936,,0.2,0,10,6,10,6
13,1,1,4,1,-5,175,148,170,5,90,2.23385290009901,,0.2,0,-5,-10,-5,-10
13,1,2,3,4,10,145,93,155,-10,80,3.46666690008715,,0.2,135,145,155,10,20
13,1,3,1,2,0,45,65,52,-7,86,2.86651179986075,,0.2,45,45,52,0,7
13,1,4,10,3,-1,89,76,89,0,100,2.63316030008718,,0.2,90,89,89,-1,-1
13,1,5,9,2,-6,39,157,20,19,62,3.86710809986107,,0.2,45,39,20,-6,-25
13,1,6,3,4,-2,133,24,142,-9,82,3.23332430003211,,0.2,135,133,142,-2,7
13,1,7,10,1,2,2,109,4,-2,96,4.13347680005245,,0.2,0,2,4,2,4
13,1,8,7,1,-6,174,124,178,-4,92,3.46674739988521,,0.2,0,-6,-2,-6,-2
13,1,9,7,3,6,96,151,94,2,96,4.29996760003269,,0.2,90,96,94,6,4
13,1,10,7,2,-6,39,43,43,-4,92,1.73309580003843,,0.2,45,39,43,-6,-2
13,1,11,6,1,9,9,7,7,2,96,2.40001139999367,,0.2,0,9,7,9,7
13,1,12,5,1,9,9,150,14,-5,90,3.93317300011404,,0.2,0,9,14,9,14
13,1,13,9,2,9,54,27,56,-2,96,2.73324660002254,,0.2,45,54,56,9,11
13,1,15,8,2,5,50,171,44,6,88,3.03351899981499,,0.2,45,50,44,5,-1
13,1,16,4,3,4,94,13,98,-4,92,4.13360169995576,,0.2,90,94,98,4,8
13,1,17,5,3,-1,89,95,90,-1,98,1.53320490010083,,0.2,90,89,90,-1,0
13,1,18,1,4,-4,131,30,131,0,100,4.40003190003335,,0.2,135,131,131,-4,-4
13,1,19,2,3,9,99,89,100,-1,98,3.39990640012547,,0.2,90,99,100,9,10
13,1,21,6,4,1,136,43,140,-4,92,3.6998519001063,,0.2,135,136,140,1,5
13,1,22,2,4,-6,129,80,129,0,100,2.89986000000499,,0.2,135,129,129,-6,-6
13,1,23,6,2,4,49,173,47,2,96,2.93317540013231,,0.2,45,49,47,4,2
13,1,24,2,1,6,6,150,8,-2,96,3.0999724001158,,0.2,0,6,8,6,8
13,1,25,9,1,8,8,154,13,-5,90,2.39949560002424,,0.2,0,8,13,8,13
13,1,26,9,3,-7,83,112,79,4,92,2.73275030008517,,0.2,90,83,79,-7,-11
13,1,27,1,4,-1,134,142,133,1,98,1.59999310015701,,0.2,135,134,133,-1,-2
13,1,28,9,2,3,48,15,44,4,92,2.19993779994547,,0.2,45,48,44,3,-1
13,1,29,5,2,4,49,19,46,3,94,3.43326449999586,,0.2,45,49,46,4,1
13,1,30,3,2,7,52,8,45,7,86,2.79984510014765,,0.2,45,52,45,7,0
13,1,31,4,2,7,52,55,61,-9,82,1.26665199990384,,0.2,45,52,61,7,16
13,1,33,2,2,5,50,84,49,1,98,3.03322859993204,,0.2,45,50,49,5,4
13,1,34,2,2,-8,37,19,35,2,96,1.96666140016168,,0.2,45,37,35,-8,-10
13,1,35,2,3,5,95,101,98,-3,94,3.1333411000669,,0.2,90,95,98,5,8
13,1,37,2,4,7,142,126,133,9,82,2.03329519997351,,0.2,135,142,133,7,-2
13,1,38,4,3,-10,80,57,81,-1,98,2.09994689980522,,0.2,90,80,81,-10,-9
13,1,39,1,1,7,7,71,4,3,94,2.96647780016065,,0.2,0,7,4,7,4
13,1,40,10,2,6,51,143,51,0,100,4.16650930000469,,0.2,45,51,51,6,6
13,1,41,3,3,10,100,19,107,-7,86,3.8334073999431,,0.2,90,100,107,10,17
13,1,42,8,3,-3,87,9,88,-1,98,4.16648050001822,,0.2,90,87,88,-3,-2
13,1,44,9,3,4,94,103,95,-1,98,2.76676760008559,,0.2,90,94,95,4,5
13,1,45,8,4,-8,127,4,131,-4,92,2.53335289983079,,0.2,135,127,131,-8,-4
13,1,46,10,1,-8,172,36,170,2,96,2.76658300007693,,0.2,0,-8,-10,-8,-10
13,1,47,7,4,10,145,26,153,-8,84,3.26675910013728,,0.2,135,145,153,10,18
13,1,48,6,2,-1,44,14,40,4,92,1.96677589998581,,0.2,45,44,40,-1,-5
13,1,50,4,1,2,2,141,2,0,100,4.46665170020424,,0.2,0,2,2,2,2
13,1,51,9,2,-9,36,156,47,-11,78,3.89997779997066,,0.2,45,36,47,-9,2
13,1,52,5,4,4,139,48,137,2,96,3.79972600005567,,0.2,135,139,137,4,2
13,1,53,8,4,-3,132,159,131,1,98,1.7664995000232,,0.2,135,132,131,-3,-4
13,1,54,8,3,0,90,39,89,1,98,3.966549199773,,0.2,90,90,89,0,-1
13,1,55,6,4,-1,134,137,137,-3,94,1.83351100003347,,0.2,135,134,137,-1,2
13,1,56,9,3,0,90,93,90,0,100,2.20001860009506,,0.2,90,90,90,0,0
13,1,57,3,3,-6,84,126,74,10,80,2.89996599988081,,0.2,90,84,74,-6,-16
13,1,58,6,3,-1,89,138,87,2,96,3.73315620003268,,0.2,90,89,87,-1,-3
13,1,59,4,4,8,143,38,141,2,96,4.19989199982956,,0.2,135,143,141,8,6
13,1,60,1,3,-7,83,125,81,2,96,2.93300900002941,,0.2,90,83,81,-7,-9
13,1,61,1,1,-6,174,159,173,1,98,2.46644380013458,,0.2,0,-6,-7,-6,-7
13,1,62,8,1,-6,174,30,170,4,92,3.70001530018635,,0.2,0,-6,-10,-6,-10
13,1,63,1,4,8,143,20,136,7,86,2.56693580001593,,0.2,135,143,136,8,1
13,1,64,3,1,-9,171,156,172,-1,98,3.46639640000649,,0.2,0,-9,-8,-9,-8
13,1,65,5,4,10,145,47,146,-1,98,4.16643019998446,,0.2,135,145,146,10,11
13,1,66,2,2,-5,40,72,39,1,98,3.13323640008457,,0.2,45,40,39,-5,-6
13,1,67,1,3,3,93,116,94,-1,98,2.29977310006507,,0.2,90,93,94,3,4
13,1,68,1,2,4,49,123,60,-11,78,3.33302940009162,,0.2,45,49,60,4,15
13,1,69,7,2,-9,36,179,32,4,92,3.63322339998558,,0.2,45,36,32,-9,-13
13,1,70,2,3,4,94,102,98,-4,92,2.4330806999933,,0.2,90,94,98,4,8
13,1,71,4,4,-9,126,40,128,-2,96,4.30009940010495,,0.2,135,126,128,-9,-7
13,1,73,5,1,4,4,60,7,-3,94,4.33342269994318,,0.2,0,4,7,4,7
13,1,75,5,2,-4,41,27,28,13,74,2.36675620009191,,0.2,45,41,28,-4,-17
13,1,76,4,3,9,99,70,104,-5,90,2.29960050014779,,0.2,90,99,104,9,14
13,1,77,8,2,1,46,34,42,4,92,1.39973489986733,,0.2,45,46,42,1,-3
13,1,78,2,1,-3,177,176,176,1,98,1.86666509998031,,0.2,0,-3,-4,-3,-4
13,1,79,8,3,-2,88,95,86,2,96,2.70014239987358,,0.2,90,88,86,-2,-4
13,1,80,3,3,2,92,23,97,-5,90,4.33333950000815,,0.2,90,92,97,2,7
13,1,81,9,4,2,137,1,144,-7,86,2.46676730015315,,0.2,135,137,144,2,9
13,1,82,7,1,-7,173,52,172,1,98,3.86658819997683,,0.2,0,-7,-8,-7,-8
13,1,83,7,3,10,100,171,101,-1,98,3.93333370005712,,0.2,90,100,101,10,11
13,1,84,4,4,-8,127,73,123,4,92,3.06679080007598,,0.2,135,127,123,-8,-12
13,1,85,9,1,-8,172,29,164,8,84,3.23305850010365,,0.2,0,-8,-16,-8,-16
13,1,86,5,1,9,9,68,2,7,86,4.53280439996161,,0.2,0,9,2,9,2
13,1,87,1,2,-2,43,38,39,4,92,1.29977790010162,,0.2,45,43,39,-2,-6
13,1,88,8,1,8,8,24,9,-1,98,3.73327070008963,,0.2,0,8,9,8,9
13,1,89,8,2,-6,39,95,41,-2,96,3.06656750012189,,0.2,45,39,41,-6,-4
13,1,90,9,4,-3,132,72,127,5,90,2.99984590010718,,0.2,135,132,127,-3,-8
13,1,92,10,2,-5,40,157,37,3,94,3.46700690011494,,0.2,45,40,37,-5,-8
13,1,93,6,2,-4,41,65,38,3,94,2.36654799990356,,0.2,45,41,38,-4,-7
13,1,94,3,1,5,5,161,11,-6,88,2.63319389987737,,0.2,0,5,11,5,11
13,1,95,6,1,-4,176,173,177,-1,98,2.23307149996981,,0.2,0,-4,-3,-4,-3
13,1,96,7,2,-8,37,153,33,4,92,3.59998670010827,,0.2,45,37,33,-8,-12
13,1,97,2,3,-8,82,97,78,4,92,3.0328259000089,,0.2,90,82,78,-8,-12
13,1,98,6,1,9,9,26,7,2,96,2.866263799835,,0.2,0,9,7,9,7
13,1,99,5,2,-2,43,154,35,8,84,4.13333339989185,,0.2,45,43,35,-2,-10
13,1,100,4,2,-5,40,7,40,0,100,3.00016800011508,,0.2,45,40,40,-5,-5
13,1,102,4,1,-1,179,121,179,0,100,3.89998469990678,,0.2,0,-1,-1,-1,-1
13,1,103,3,4,6,141,108,141,0,100,2.89975189999677,,0.2,135,141,141,6,6
13,1,104,10,4,7,142,163,146,-4,92,1.8998828001786,,0.2,135,142,146,7,11
13,1,105,2,4,-7,128,98,134,-6,88,2.83331619994715,,0.2,135,128,134,-7,-1
13,1,106,5,3,-9,81,122,76,5,90,2.79984200000763,,0.2,90,81,76,-9,-14
13,1,108,10,4,-8,127,173,126,1,98,2.70000670012087,,0.2,135,127,126,-8,-9
13,1,110,3,4,-10,125,90,128,-3,94,2.36678629997186,,0.2,135,125,128,-10,-7
13,1,111,10,4,4,139,16,141,-2,96,3.73340809997171,,0.2,135,139,141,4,6
13,1,112,9,1,9,9,19,13,-4,92,1.5998249000404,,0.2,0,9,13,9,13
13,1,113,9,4,-2,133,166,134,-1,98,2.79990549990907,,0.2,135,133,134,-2,-1
13,1,114,5,4,-5,130,5,132,-2,96,2.93323679990135,,0.2,135,130,132,-5,-3
13,1,115,6,4,3,138,146,145,-7,86,1.03303149994463,,0.2,135,138,145,3,10
13,1,116,6,3,-8,82,52,75,7,86,2.29972200002521,,0.2,90,82,75,-8,-15
13,1,118,7,4,9,144,168,146,-2,96,1.56677899998613,,0.2,135,144,146,9,11
13,1,119,3,1,-2,178,71,176,2,96,4.09995909989811,,0.2,0,-2,-4,-2,-4
13,1,122,8,3,2,92,83,93,-1,98,3.1670315999072,,0.2,90,92,93,2,3
13,1,123,10,3,-9,81,7,76,5,90,4.06666820007376,,0.2,90,81,76,-9,-14
13,1,124,9,3,6,96,95,96,0,100,1.43317919992842,,0.2,90,96,96,6,6
13,1,125,7,3,0,90,48,90,0,100,2.93319440004416,,0.2,90,90,90,0,0
13,1,126,5,3,9,99,60,101,-2,96,3.83305149991065,,0.2,90,99,101,9,11
13,1,127,2,2,8,53,76,59,-6,88,3.8666284000501,,0.2,45,53,59,8,14
13,1,129,4,2,-1,44,43,39,5,90,4.2333414000459,,0.2,45,44,39,-1,-6
13,1,131,7,3,4,94,76,99,-5,90,3.26656710007228,,0.2,90,94,99,4,9
13,1,132,6,4,0,135,70,130,5,90,3.39992420002818,,0.2,135,135,130,0,-5
13,1,133,2,1,7,7,7,5,2,96,3.36638109991327,,0.2,0,7,5,7,5
13,1,134,2,4,2,137,67,139,-2,96,3.83329849992879,,0.2,135,137,139,2,4
13,1,136,4,2,-6,39,120,45,-6,88,4.16657300014049,,0.2,45,39,45,-6,0
13,1,137,5,3,9,99,149,99,0,100,3.79993280000053,,0.2,90,99,99,9,9
13,1,138,4,1,4,4,10,4,0,100,1.76641770009883,,0.2,0,4,4,4,4
13,1,139,3,2,1,46,32,39,7,86,1.53325749980286,,0.2,45,46,39,1,-6
13,1,140,7,1,-2,178,150,179,-1,98,3.20004579983652,,0.2,0,-2,-1,-2,-1
13,1,141,7,4,3,138,78,133,5,90,3.66651759995148,,0.2,135,138,133,3,-2
13,1,142,4,3,10,100,138,106,-6,88,2.46640860009938,,0.2,90,100,106,10,16
13,1,143,6,2,-6,39,31,34,5,90,1.36652230005711,,0.2,45,39,34,-6,-11
13,1,144,9,4,-2,133,111,132,1,98,2.66662480006926,,0.2,135,133,132,-2,-3
13,1,145,6,3,3,93,41,97,-4,92,3.33305960008875,,0.2,90,93,97,3,7
13,1,146,7,4,-5,130,68,126,4,92,3.63288619997911,,0.2,135,130,126,-5,-9
13,1,147,10,2,5,50,101,58,-8,84,2.93346110009588,,0.2,45,50,58,5,13
13,1,148,5,4,-6,129,91,123,6,88,3.33332710014656,,0.2,135,129,123,-6,-12
13,1,149,3,2,-6,39,86,29,10,80,3.79981740005314,,0.2,45,39,29,-6,-16
13,1,152,1,2,5,50,77,52,-2,96,1.90009190002456,,0.2,45,50,52,5,7
13,1,153,1,3,-1,89,43,90,-1,98,3.66678820014931,,0.2,90,89,90,-1,0
13,1,154,7,1,1,1,25,2,-1,98,2.96667700004764,,0.2,0,1,2,1,2
13,1,155,7,2,4,49,136,47,2,96,4.16645620018244,,0.2,45,49,47,4,2
13,1,157,3,3,-8,82,101,77,5,90,3.23340270016342,,0.2,90,82,77,-8,-13
13,1,158,3,2,-1,44,69,46,-2,96,2.3000360999722,,0.2,45,44,46,-1,1
13,1,159,8,1,-4,176,73,176,0,100,4.46646980009973,,0.2,0,-4,-4,-4,-4
13,1,160,3,1,10,10,142,10,0,100,3.46661300002597,,0.2,0,10,10,10,10
14,1,1,4,1,6,6,170,6,0,100,2.10304870014079,,0.2,0,6,6,6,6
14,1,2,2,1,-7,173,137,168,5,90,2.75756120006554,,0.2,0,-7,-12,-7,-12
14,1,3,10,3,-5,85,33,83,2,96,2.70298230019398,,0.2,90,85,83,-5,-7
14,1,4,9,2,5,50,98,57,-7,86,2.39970189984888,,0.2,45,50,57,5,12
14,1,5,6,4,9,144,154,148,-4,92,1.69775429996662,,0.2,135,144,148,9,13
14,1,6,9,1,-7,173,81,169,4,92,3.52738299989142,,0.2,0,-7,-11,-7,-11
14,1,7,7,2,-6,39,97,49,-10,80,2.70904519991018,,0.2,45,39,49,-6,4
14,1,8,10,2,3,48,66,37,11,78,2.745428299997,,0.2,45,48,37,3,-8
14,1,9,7,1,-7,173,27,5,-12,76,3.81186680006795,,0.2,0,-7,5,-7,5
14,1,10,8,2,-9,36,163,39,-3,94,2.59355089999735,,0.2,45,36,39,-9,-6
14,1,11,6,1,0,0,146,176,4,92,2.7688035001047,,0.2,0,0,-4,0,-4
14,1,12,5,2,9,54,0,42,12,76,2.24827510002069,,0.2,45,54,42,9,-3
14,1,13,3,3,-7,83,59,77,6,88,3.01784580014646,,0.2,90,83,77,-7,-13
14,1,14,6,3,3,93,15,96,-3,94,2.55097670014948,,0.2,90,93,96,3,6
14,1,15,7,2,1,46,123,53,-7,86,3.84816409996711,,0.2,45,46,53,1,8
14,1,16,9,2,-7,38,170,25,13,74,3.16932330001146,,0.2,45,38,25,-7,-20
14,1,17,10,4,-5,130,157,131,-1,98,2.55113849998452,,0.2,135,130,131,-5,-4
14,1,18,2,3,2,92,167,91,1,98,2.49650650005788,,0.2,90,92,91,2,1
14,1,19,6,2,9,54,45,60,-6,88,3.30242510000244,,0.2,45,54,60,9,15
14,1,20,9,2,9,54,15,57,-3,94,1.70835689990781,,0.2,45,54,57,9,12
14,1,21,3,2,1,46,75,49,-3,94,2.25410519982688,,0.2,45,46,49,1,4
14,1,22,4,4,7,142,41,151,-9,82,1.89131640014239,,0.2,135,142,151,7,16
14,1,23,8,3,2,92,6,100,-8,84,3.2602466000244,,0.2,90,92,100,2,10
14,1,24,2,4,0,135,103,141,-6,88,1.72721459995955,,0.2,135,135,141,0,6
14,1,25,2,1,8,8,127,4,4,92,1.82418550015427,,0.2,0,8,4,8,4
14,1,26,9,4,7,142,167,151,-9,82,1.72122170007788,,0.2,135,142,151,7,16
14,1,27,4,1,0,0,33,0,0,100,2.18756949994713,,0.2,0,0,0,0,0
14,1,28,9,4,3,138,4,144,-6,88,1.8242061000783,,0.2,135,138,144,3,9
14,1,29,10,1,5,5,17,9,-4,92,2.5571824000217,,0.2,0,5,9,5,9
14,1,30,5,2,-3,42,88,50,-8,84,3.71438080002554,,0.2,45,42,50,-3,5
14,1,32,1,4,7,142,82,142,0,100,2.41801239992492,,0.2,135,142,142,7,7
14,1,33,4,2,-4,41,149,40,1,98,3.49635960021988,,0.2,45,41,40,-4,-5
14,1,34,4,3,-4,86,178,87,-1,98,2.40575070003979,,0.2,90,86,87,-4,-3
14,1,35,5,4,-9,126,132,132,-6,88,0.715162500040606,,0.2,135,126,132,-9,-3
14,1,36,4,2,10,55,162,59,-4,92,3.92117680003867,,0.2,45,55,59,10,14
14,1,37,10,4,-8,127,46,129,-2,96,2.90262540010735,,0.2,135,127,129,-8,-6
14,1,38,8,3,3,93,81,96,-3,94,1.5152204001788,,0.2,90,93,96,3,6
14,1,39,1,1,-9,171,38,173,-2,96,2.66046270006336,,0.2,0,-9,-7,-9,-7
14,1,40,9,3,-5,85,149,88,-3,94,2.51450180006213,,0.2,90,85,88,-5,-2
14,1,41,8,1,-6,174,90,171,3,94,2.33302010013722,,0.2,0,-6,-9,-6,-9
14,1,42,6,4,8,143,31,149,-6,88,2.42976289987564,,0.2,135,143,149,8,14
14,1,43,3,2,-4,41,114,40,1,98,2.19967879983597,,0.2,45,41,40,-4,-5
14,1,44,1,4,-4,131,31,135,-4,92,2.24830240011215,,0.2,135,131,135,-4,0
14,1,45,5,4,1,136,113,137,-1,98,1.90317980013788,,0.2,135,136,137,1,2
14,1,46,6,4,2,137,41,133,4,92,2.17540219984949,,0.2,135,137,133,2,-2
14,1,47,10,1,-6,174,38,176,-2,96,1.66052370006219,,0.2,0,-6,-4,-6,-4
14,1,48,7,4,5,140,121,134,6,88,2.07861069985665,,0.2,135,140,134,5,-1
14,1,49,6,2,1,46,117,43,3,94,2.62371450010687,,0.2,45,46,43,1,-2
14,1,50,1,3,-9,81,171,79,2,96,3.95689109992236,,0.2,90,81,79,-9,-11
14,1,51,5,3,-2,88,91,85,3,94,3.18771480000578,,0.2,90,88,85,-2,-5
14,1,52,9,4,-1,134,151,135,-1,98,2.14509639982134,,0.2,135,134,135,-1,0
14,1,53,7,1,-6,174,157,172,2,96,2.00561179989018,,0.2,0,-6,-8,-6,-8
14,1,54,7,3,2,92,92,92,0,100,1.64847340015694,,0.2,90,92,92,2,2
14,1,55,2,4,-9,126,105,131,-5,90,2.05459780013189,,0.2,135,126,131,-9,-4
14,1,56,6,3,-4,86,125,87,-1,98,1.79998590005562,,0.2,90,86,87,-4,-3
14,1,57,7,4,-7,128,83,119,9,82,2.26036870013922,,0.2,135,128,119,-7,-16
14,1,58,1,2,8,53,108,62,-9,82,2.35748180001974,,0.2,45,53,62,8,17
14,1,59,7,3,8,98,154,98,0,100,2.59980919980444,,0.2,90,98,98,8,8
14,1,60,6,2,-9,36,125,38,-2,96,2.70858859992586,,0.2,45,36,38,-9,-7
14,1,61,3,4,-9,126,107,120,6,88,1.85428610001691,,0.2,135,126,120,-9,-15
14,1,62,3,2,0,45,160,48,-3,94,2.66029389994219,,0.2,45,45,48,0,3
14,1,63,9,3,-6,84,133,86,-2,96,1.99370729993097,,0.2,90,84,86,-6,-4
14,1,64,2,1,-4,176,111,177,-1,98,2.29073620005511,,0.2,0,-4,-3,-4,-3
14,1,65,9,3,-2,88,173,87,1,98,3.38737669982947,,0.2,90,88,87,-2,-3
14,1,66,2,1,6,6,128,6,0,100,2.66663140011951,,0.2,0,6,6,6,6
14,1,67,4,4,4,139,63,137,2,96,3.9384983999189,,0.2,135,139,137,4,2
14,1,68,7,4,5,140,129,145,-5,90,1.98163240007125,,0.2,135,140,145,5,10
14,1,69,8,1,-5,175,86,173,2,96,2.42997579998337,,0.2,0,-5,-7,-5,-7
14,1,70,9,3,-2,88,146,86,2,96,2.38772220001556,,0.2,90,88,86,-2,-4
14,1,71,5,1,5,5,15,8,-3,94,3.45401079999283,,0.2,0,5,8,5,8
14,1,72,5,2,4,49,26,49,0,100,1.97550749988295,,0.2,45,49,49,4,4
14,1,73,8,4,4,139,4,138,1,98,2.07246539997868,,0.2,135,139,138,4,3
14,1,74,5,3,1,91,132,88,3,94,3.91453619999811,,0.2,90,91,88,1,-2
14,1,75,10,4,9,144,87,150,-6,88,2.73885229998268,,0.2,135,144,150,9,15
14,1,76,8,4,4,139,31,130,9,82,3.04221970005892,,0.2,135,139,130,4,-5
14,1,77,7,2,9,54,50,50,4,92,1.0786321000196,,0.2,45,54,50,9,5
14,1,78,1,3,6,96,98,92,4,92,2.22392780007794,,0.2,90,96,92,6,2
14,1,79,6,3,-6,84,157,82,2,96,2.96939560002647,,0.2,90,84,82,-6,-8
14,1,80,4,3,-9,81,14,88,-7,86,2.3629854999017,,0.2,90,81,88,-9,-2
14,1,81,1,1,-5,175,175,175,0,100,1.84180709999055,,0.2,0,-5,-5,-5,-5
14,1,82,1,4,-9,126,35,124,2,96,2.97555989981629,,0.2,135,126,124,-9,-11
14,1,83,2,3,-9,81,19,80,1,98,3.25395400007255,,0.2,90,81,80,-9,-10
14,1,84,3,4,9,144,82,138,6,88,2.06620489992201,,0.2,135,144,138,9,3
14,1,85,8,4,0,135,123,137,-2,96,1.41215549991466,,0.2,135,135,137,0,2
14,1,86,2,2,8,53,161,41,12,76,2.11491580004804,,0.2,45,53,41,8,-4
14,1,87,6,1,-1,179,115,179,0,100,2.23638099990785,,0.2,0,-1,-1,-1,-1
14,1,88,5,4,6,141,66,136,5,90,1.56956030009314,,0.2,135,141,136,6,1
14,1,89,8,1,-1,179,157,177,2,96,3.07842849986628,,0.2,0,-1,-3,-1,-3
14,1,90,5,1,1,1,84,2,-1,98,3.14486699993722,,0.2,0,1,2,1,2
14,1,91,9,1,0,0,71,179,1,98,3.60559049993753,,0.2,0,0,-1,0,-1
14,1,92,3,3,-7,83,44,85,-2,96,2.57504619983956,,0.2,90,83,85,-7,-5
14,1,93,3,1,6,6,18,8,-2,96,1.84814910008572,,0.2,0,6,8,6,8
14,1,95,4,3,8,98,86,101,-3,94,2.17529649985954,,0.2,90,98,101,8,11
14,1,96,7,2,-7,38,65,44,-6,88,2.08494630013593,,0.2,45,38,44,-7,-1
14,1,97,10,3,-10,80,165,83,-3,94,2.49028229992837,,0.2,90,80,83,-10,-7
14,1,98,1,2,1,46,7,32,14,72,2.09655159991235,,0.2,45,46,32,1,-13
14,1,99,9,1,4,4,163,178,6,88,2.90292590018362,,0.2,0,4,-2,4,-2
14,1,100,3,1,-7,173,168,172,1,98,2.51498620002531,,0.2,0,-7,-8,-7,-8
14,1,101,4,1,7,7,110,10,-3,94,2.78128799982369,,0.2,0,7,10,7,10
14,1,102,2,4,2,137,56,134,3,94,2.71461540018208,,0.2,135,137,134,2,-1
14,1,103,10,3,5,95,18,94,1,98,3.76328619988635,,0.2,90,95,94,5,4
14,1,104,7,3,3,93,153,96,-3,94,2.60578479990363,,0.2,90,93,96,3,6
14,1,105,10,2,2,47,57,57,-10,80,1.19982300000265,,0.2,45,47,57,2,12
14,1,106,3,1,1,1,28,177,4,92,4.25990340020508,,0.2,0,1,-3,1,-3
14,1,107,4,1,-8,172,166,170,2,96,2.38139689993113,,0.2,0,-8,-10,-8,-10
14,1,108,1,4,-9,126,89,115,11,78,2.27261459990405,,0.2,135,126,115,-9,-20
14,1,109,8,2,3,48,148,65,-17,66,2.81768699991517,,0.2,45,48,65,3,20
14,1,110,6,3,-3,87,103,85,2,96,2.31509739998728,,0.2,90,87,85,-3,-5
14,1,111,3,2,-9,36,27,40,-4,92,2.21211180021055,,0.2,45,36,40,-9,-5
14,1,112,9,2,1,46,88,60,-14,72,2.40601949999109,,0.2,45,46,60,1,15
14,1,113,8,3,9,99,99,99,0,100,1.70278119994327,,0.2,90,99,99,9,9
14,1,114,10,1,-7,173,57,172,1,98,2.29672680003569,,0.2,0,-7,-8,-7,-8
14,1,115,5,1,-8,172,113,173,-1,98,2.19377980008721,,0.2,0,-8,-7,-8,-7
14,1,116,3,3,-4,86,117,86,0,100,1.64817449986003,,0.2,90,86,86,-4,-4
14,1,117,8,2,6,51,61,61,-10,80,2.67248820001259,,0.2,45,51,61,6,16
14,1,118,10,4,0,135,5,141,-6,88,2.96313380007632,,0.2,135,135,141,0,6
14,1,119,2,3,-6,84,76,83,1,98,4.35109640005976,,0.2,90,84,83,-6,-7
14,1,120,5,1,-8,172,104,174,-2,96,3.0781561001204,,0.2,0,-8,-6,-8,-6
14,1,121,1,2,-7,38,136,36,2,96,2.16308900015429,,0.2,45,38,36,-7,-9
14,1,122,10,2,-5,40,102,36,4,92,1.93290839996189,,0.2,45,40,36,-5,-9
14,1,123,8,4,-3,132,122,139,-7,86,1.69072389998473,,0.2,135,132,139,-3,4
14,1,124,4,4,-5,130,60,137,-7,86,2.41179640009068,,0.2,135,130,137,-5,2
14,1,125,2,2,0,45,106,44,1,98,2.02990849991329,,0.2,45,45,44,0,-1
14,1,126,3,1,-9,171,111,171,0,100,2.65411980007775,,0.2,0,-9,-9,-9,-9
14,1,127,1,2,9,54,33,50,4,92,1.74496389995329,,0.2,45,54,50,9,5
14,1,128,4,4,4,139,136,136,3,94,0.91528209997341,,0.2,135,139,136,4,1
14,1,129,7,1,4,4,89,10,-6,88,3.78719389997423,,0.2,0,4,10,4,10
14,1,130,7,4,5,140,59,142,-2,96,2.43610539985821,,0.2,135,140,142,5,7
14,1,131,1,1,-2,178,90,175,3,94,4.39311710000038,,0.2,0,-2,-5,-2,-5
14,1,132,4,2,-3,42,126,34,8,84,2.62366310018115,,0.2,45,42,34,-3,-11
14,1,133,2,4,3,138,25,141,-3,94,1.43020560010336,,0.2,135,138,141,3,6
14,1,134,10,2,7,52,50,42,10,80,1.46659129997715,,0.2,45,52,42,7,-3
14,1,135,8,2,8,53,18,47,6,88,2.12079620012082,,0.2,45,53,47,8,2
14,1,136,9,1,6,6,151,11,-5,90,2.42980589997023,,0.2,0,6,11,6,11
14,1,137,10,1,-3,177,152,178,-1,98,2.51463690004312,,0.2,0,-3,-2,-3,-2
14,1,138,9,4,-8,127,4,138,-11,78,2.10896619991399,,0.2,135,127,138,-8,3
14,1,139,5,3,5,95,5,95,0,100,2.175731100142,,0.2,90,95,95,5,5
14,1,140,4,2,1,46,176,41,5,90,1.88456870010123,,0.2,45,46,41,1,-4
14,1,141,2,2,3,48,87,47,1,98,1.89093840005808,,0.2,45,48,47,3,2
14,1,142,1,3,-8,82,60,79,3,94,1.95089320000261,,0.2,90,82,79,-8,-11
14,1,143,5,3,-3,87,178,89,-2,96,2.14503109990619,,0.2,90,87,89,-3,-1
14,1,144,8,3,-6,84,130,85,-1,98,3.13886629999615,,0.2,90,84,85,-6,-5
14,1,145,8,1,-5,175,113,178,-3,94,2.62399560003541,,0.2,0,-5,-2,-5,-2
14,1,146,6,2,-6,39,147,35,4,92,1.605865099933,,0.2,45,39,35,-6,-10
14,1,147,3,3,2,92,168,92,0,100,2.56338570010848,,0.2,90,92,92,2,2
14,1,148,1,1,8,8,4,10,-2,96,2.48466840013862,,0.2,0,8,10,8,10
14,1,149,10,3,-9,81,127,86,-5,90,1.5819434998557,,0.2,90,81,86,-9,-4
14,1,150,2,3,-6,84,46,84,0,100,1.53928309981711,,0.2,90,84,84,-6,-6
14,1,151,7,1,10,10,49,15,-5,90,2.98131710011512,,0.2,0,10,15,10,15
14,1,152,6,4,6,141,128,136,5,90,1.77554920013063,,0.2,135,141,136,6,1
14,1,153,6,1,-9,171,36,174,-3,94,2.28444760013372,,0.2,0,-9,-6,-9,-6
14,1,154,3,4,-6,129,55,117,12,76,2.53351199999452,,0.2,135,129,117,-6,-18
14,1,155,7,3,-1,89,93,90,-1,98,3.31462249998003,,0.2,90,89,90,-1,0
14,1,156,1,3,0,90,18,89,1,98,3.59940700000152,,0.2,90,90,89,0,-1
14,1,157,6,1,-3,177,172,176,1,98,2.43008630000986,,0.2,0,-3,-4,-3,-4
14,1,158,5,4,1,136,149,143,-7,86,3.95090320007876,,0.2,135,136,143,1,8
14,1,159,2,2,-6,39,20,26,13,74,1.65448600007221,,0.2,45,39,26,-6,-19
14,1,160,3,4,-8,127,162,133,-6,88,1.8063616999425,,0.2,135,127,133,-8,-2
15,1,1,4,1,6,6,170,8,-2,96,3.2608762,,0.2,0,6,8,6,8
15,1,2,2,1,-7,173,137,171,2,96,1.98229809999999,,0.2,0,-7,-9,-7,-9
15,1,3,10,3,-5,85,33,85,0,100,2.1757293,,0.2,90,85,85,-5,-5
15,1,5,6,4,9,144,154,152,-8,84,1.6794064,,0.2,135,144,152,9,17
15,1,6,9,1,-7,173,81,175,-2,96,2.27300840000001,,0.2,0,-7,-5,-7,-5
15,1,7,7,2,-6,39,97,45,-6,88,1.86653379999998,,0.2,45,39,45,-6,0
15,1,8,10,2,3,48,66,41,7,86,1.62414949999999,,0.2,45,48,41,3,-4
15,1,9,7,1,-7,173,27,173,0,100,2.5943523,,0.2,0,-7,-7,-7,-7
15,1,10,8,2,-9,36,163,30,6,88,2.00001590000002,,0.2,45,36,30,-9,-15
15,1,11,6,1,0,0,146,1,-1,98,2.87833470000001,,0.2,0,0,1,0,1
15,1,12,5,2,9,54,0,51,3,94,1.58173210000001,,0.2,45,54,51,9,6
15,1,13,3,3,-7,83,59,84,-1,98,1.72730330000002,,0.2,90,83,84,-7,-6
15,1,14,6,3,3,93,15,96,-3,94,1.6062652,,0.2,90,93,96,3,6
15,1,15,7,2,1,46,123,47,-1,98,1.64253189999999,,0.2,45,46,47,1,2
15,1,16,9,2,-7,38,170,31,7,86,1.35784029999999,,0.2,45,38,31,-7,-14
15,1,17,10,4,-5,130,157,130,0,100,1.99369140000002,,0.2,135,130,130,-5,-5
15,1,18,2,3,2,92,167,92,0,100,2.45283570000001,,0.2,90,92,92,2,2
15,1,19,6,2,9,54,45,49,5,90,1.42423969999999,,0.2,45,54,49,9,4
15,1,20,9,2,9,54,15,51,3,94,1.4060197,,0.2,45,54,51,9,6
15,1,21,3,2,1,46,75,50,-4,92,1.3295038,,0.2,45,46,50,1,5
15,1,22,4,4,7,142,41,145,-3,94,1.63025060000001,,0.2,135,142,145,7,10
15,1,23,8,3,2,92,6,95,-3,94,2.18782210000001,,0.2,90,92,95,2,5
15,1,24,2,4,0,135,103,137,-2,96,1.39962809999997,,0.2,135,135,137,0,2
15,1,25,2,1,8,8,127,4,4,92,1.16368299999999,,0.2,0,8,4,8,4
15,1,26,9,4,7,142,167,142,0,100,1.57564480000002,,0.2,135,142,142,7,7
15,1,27,4,1,0,0,33,178,2,96,1.41847839999997,,0.2,0,0,-2,0,-2
15,1,28,9,4,3,138,4,136,2,96,2.15142600000001,,0.2,135,138,136,3,1
15,1,29,10,1,5,5,17,1,4,92,1.96993200000003,,0.2,0,5,1,5,1
15,1,30,5,2,-3,42,88,49,-7,86,1.8361367,,0.2,45,42,49,-3,4
15,1,31,4,3,4,94,162,91,3,94,2.61825220000003,,0.2,90,94,91,4,1
15,1,32,1,4,7,142,82,146,-4,92,1.97569400000003,,0.2,135,142,146,7,11
15,1,33,4,2,-4,41,149,40,1,98,2.08506690000002,,0.2,45,41,40,-4,-5
15,1,34,4,3,-4,86,178,84,2,96,3.19668150000001,,0.2,90,86,84,-4,-6
15,1,35,5,4,-9,126,132,122,4,92,1.34539530000001,,0.2,135,126,122,-9,-13
15,1,36,4,2,10,55,162,43,12,76,1.38176420000002,,0.2,45,55,43,10,-2
15,1,37,10,4,-8,127,46,128,-1,98,1.53934650000002,,0.2,135,127,128,-8,-7
15,1,38,8,3,3,93,81,90,3,94,1.56355810000002,,0.2,90,93,90,3,0
15,1,39,1,1,-9,171,38,173,-2,96,1.12103150000002,,0.2,0,-9,-7,-9,-7
15,1,40,9,3,-5,85,149,87,-2,96,3.37503830000003,,0.2,90,85,87,-5,-3
15,1,41,8,1,-6,174,90,170,4,92,2.44234440000002,,0.2,0,-6,-10,-6,-10
15,1,42,6,4,8,143,31,146,-3,94,1.61202630000003,,0.2,135,143,146,8,11
15,1,43,3,2,-4,41,114,54,-13,74,1.34534529999996,,0.2,45,41,54,-4,9
15,1,44,1,4,-4,131,31,140,-9,82,1.76352639999999,,0.2,135,131,140,-4,5
15,1,45,5,4,1,136,113,136,0,100,1.5696299,,0.2,135,136,136,1,1
15,1,46,6,4,2,137,41,133,4,92,2.2908875,,0.2,135,137,133,2,-2
15,1,47,10,1,-6,174,38,170,4,92,1.78790260000005,,0.2,0,-6,-10,-6,-10
15,1,48,7,4,5,140,121,142,-2,96,1.51494180000003,,0.2,135,140,142,5,7
15,1,49,6,2,1,46,117,53,-7,86,1.35144929999996,,0.2,45,46,53,1,8
15,1,50,1,3,-9,81,171,70,11,78,2.57591439999999,,0.2,90,81,70,-9,-20
15,1,51,5,3,-2,88,91,85,3,94,1.40599860000009,,0.2,90,88,85,-2,-5
15,1,53,7,1,-6,174,157,174,0,100,1.99393789999999,,0.2,0,-6,-6,-6,-6
15,1,55,2,4,-9,126,105,129,-3,94,1.41211109999995,,0.2,135,126,129,-9,-6
15,1,57,7,4,-7,128,83,126,2,96,1.68121939999992,,0.2,135,128,126,-7,-9
15,1,58,1,2,8,53,108,59,-6,88,1.58781529999999,,0.2,45,53,59,8,14
15,1,59,7,3,8,98,154,95,3,94,2.61203479999995,,0.2,90,98,95,8,5
15,1,60,6,2,-9,36,125,36,0,100,2.23630560000004,,0.2,45,36,36,-9,-9
15,1,61,3,4,-9,126,107,118,8,84,0.981720300000006,,0.2,135,126,118,-9,-17
15,1,62,3,2,0,45,160,40,5,90,1.78771469999992,,0.2,45,45,40,0,-5
15,1,63,9,3,-6,84,133,80,4,92,1.95748270000001,,0.2,90,84,80,-6,-10
15,1,64,2,1,-4,176,111,177,-1,98,2.01812999999993,,0.2,0,-4,-3,-4,-3
15,1,65,9,3,-2,88,173,88,0,100,1.47268780000002,,0.2,90,88,88,-2,-2
15,1,66,2,1,6,6,128,10,-4,92,1.53927390000001,,0.2,0,6,10,6,10
15,1,67,4,4,4,139,63,142,-3,94,1.77567039999997,,0.2,135,139,142,4,7
15,1,68,7,4,5,140,129,149,-9,82,2.34528590000002,,0.2,135,140,149,5,14
15,1,70,9,3,-2,88,146,90,-2,96,3.18655349999995,,0.2,90,88,90,-2,0
15,1,71,5,1,5,5,15,7,-2,96,2.24869249999995,,0.2,0,5,7,5,7
15,1,72,5,2,4,49,26,44,5,90,1.44246910000004,,0.2,45,49,44,4,-1
15,1,73,8,4,4,139,4,142,-3,94,1.86676059999991,,0.2,135,139,142,4,7
15,1,74,5,3,1,91,132,95,-4,92,1.99384839999993,,0.2,90,91,95,1,5
15,1,75,10,4,9,144,87,135,9,82,1.29086359999997,,0.2,135,144,135,9,0
15,1,76,8,4,4,139,31,153,-14,72,2.32127609999998,,0.2,135,139,153,4,18
15,1,77,7,2,9,54,50,50,4,92,0.981759900000043,,0.2,45,54,50,9,5
15,1,78,1,3,6,96,98,92,4,92,1.95169190000001,,0.2,90,96,92,6,2
15,1,79,6,3,-6,84,157,83,1,98,2.44246029999999,,0.2,90,84,83,-6,-7
15,1,80,4,3,-9,81,14,83,-2,96,2.17567269999995,,0.2,90,81,83,-9,-7
15,1,81,1,1,-5,175,175,176,-1,98,1.5576767,,0.2,0,-5,-4,-5,-4
15,1,82,1,4,-9,126,35,133,-7,86,1.64868030000002,,0.2,135,126,133,-9,-2
15,1,83,2,3,-9,81,19,77,4,92,1.89699810000002,,0.2,90,81,77,-9,-13
15,1,84,3,4,9,144,82,145,-1,98,3.82405719999997,,0.2,135,144,145,9,10
15,1,85,8,4,0,135,123,128,7,86,2.08430749999991,,0.2,135,135,128,0,-7
15,1,86,2,2,8,53,161,58,-5,90,1.93945770000005,,0.2,45,53,58,8,13
15,1,87,6,1,-1,179,115,177,2,96,2.8119625999999,,0.2,0,-1,-3,-1,-3
15,1,88,5,4,6,141,66,141,0,100,2.38787809999997,,0.2,135,141,141,6,6
15,1,92,3,3,-7,83,44,84,-1,98,1.6848463,,0.2,90,83,84,-7,-6
15,1,93,3,1,6,6,18,5,1,98,1.5331291,,0.2,0,6,5,6,5
15,1,94,5,2,4,49,143,48,1,98,2.12669949999997,,0.2,45,49,48,4,3
15,1,95,4,3,8,98,86,101,-3,94,2.38176839999994,,0.2,90,98,101,8,11
15,1,96,7,2,-7,38,65,31,7,86,2.01214759999993,,0.2,45,38,31,-7,-14
15,1,97,10,3,-10,80,165,84,-4,92,2.90112799999997,,0.2,90,80,84,-10,-6
15,1,98,1,2,1,46,7,41,5,90,1.27304129999993,,0.2,45,46,41,1,-4
15,1,99,9,1,4,4,163,6,-2,96,2.09084099999995,,0.2,0,4,6,4,6
15,1,100,3,1,-7,173,168,173,0,100,1.72112979999997,,0.2,0,-7,-7,-7,-7
15,1,101,4,1,7,7,110,0,7,86,2.78192129999991,,0.2,0,7,0,7,0
15,1,102,2,4,2,137,56,139,-2,96,2.15146660000005,,0.2,135,137,139,2,4
15,1,103,10,3,5,95,18,97,-2,96,2.60583800000006,,0.2,90,95,97,5,7
15,1,104,7,3,3,93,153,95,-2,96,2.42414329999997,,0.2,90,93,95,3,5
15,1,105,10,2,2,47,57,36,11,78,1.55758229999992,,0.2,45,47,36,2,-9
15,1,106,3,1,1,1,28,177,4,92,3.0118215,,0.2,0,1,-3,1,-3
15,1,107,4,1,-8,172,166,168,4,92,1.66055329999995,,0.2,0,-8,-12,-8,-12
15,1,108,1,4,-9,126,89,120,6,88,2.45439899999997,,0.2,135,126,120,-9,-15
15,1,109,8,2,3,48,148,55,-7,86,2.12109869999995,,0.2,45,48,55,3,10
15,1,110,6,3,-3,87,103,88,-1,98,1.01194410000016,,0.2,90,87,88,-3,-2
15,1,111,3,2,-9,36,27,26,10,80,1.16981480000004,,0.2,45,36,26,-9,-19
15,1,112,9,2,1,46,88,51,-5,90,2.27266789999999,,0.2,45,46,51,1,6
15,1,113,8,3,9,99,99,99,0,100,0.957484099999874,,0.2,90,99,99,9,9
15,1,114,10,1,-7,173,57,172,1,98,1.48509810000019,,0.2,0,-7,-8,-7,-8
15,1,115,5,1,-8,172,113,174,-2,96,2.99380859999997,,0.2,0,-8,-6,-8,-6
15,1,116,3,3,-4,86,117,82,4,92,2.0600872,,0.2,90,86,82,-4,-8
15,1,117,8,2,6,51,61,51,0,100,1.29710410000007,,0.2,45,51,51,6,6
15,1,118,10,4,0,135,5,149,-14,72,2.05447189999995,,0.2,135,135,149,0,14
15,1,119,2,3,-6,84,76,78,6,88,1.16991189999999,,0.2,90,84,78,-6,-12
15,1,120,5,1,-8,172,104,165,7,86,2.38182960000017,,0.2,0,-8,-15,-8,-15
15,1,121,1,2,-7,38,136,31,7,86,1.75775489999978,,0.2,45,38,31,-7,-14
15,1,122,10,2,-5,40,102,33,7,86,1.5274508,,0.2,45,40,33,-5,-12
15,1,123,8,4,-3,132,122,122,10,80,0.884939799999984,,0.2,135,132,122,-3,-13
15,1,124,4,4,-5,130,60,123,7,86,1.8339375999999,,0.2,135,130,123,-5,-12
15,1,125,2,2,0,45,106,47,-2,96,2.15150390000008,,0.2,45,45,47,0,2
15,1,126,3,1,-9,171,111,170,1,98,2.15748010000016,,0.2,0,-9,-10,-9,-10
15,1,127,1,2,9,54,33,56,-2,96,1.17571509999993,,0.2,45,54,56,9,11
15,1,128,4,4,4,139,136,136,3,94,1.28459960000009,,0.2,135,139,136,4,1
15,1,129,7,1,4,4,89,0,4,92,1.9515245,,0.2,0,4,0,4,0
15,1,130,7,4,5,140,59,142,-2,96,2.49694250000016,,0.2,135,140,142,5,7
15,1,131,1,1,-2,178,90,175,3,94,3.0421824,,0.2,0,-2,-5,-2,-5
15,1,132,4,2,-3,42,126,33,9,82,1.81208539999989,,0.2,45,42,33,-3,-12
15,1,133,2,4,3,138,25,140,-2,96,1.76978379999991,,0.2,135,138,140,3,5
15,1,134,10,2,7,52,50,54,-2,96,1.71510449999982,,0.2,45,52,54,7,9
15,1,135,8,2,8,53,18,57,-4,92,1.34536719999983,,0.2,45,53,57,8,12
15,1,136,9,1,6,6,151,11,-5,90,2.64834300000007,,0.2,0,6,11,6,11
15,1,137,10,1,-3,177,152,178,-1,98,2.63006300000006,,0.2,0,-3,-2,-3,-2
15,1,138,9,4,-8,127,4,120,7,86,1.90900020000004,,0.2,135,127,120,-8,-15
15,1,139,5,3,5,95,5,98,-3,94,2.50302259999989,,0.2,90,95,98,5,8
15,1,140,4,2,1,46,176,48,-2,96,1.39997310000012,,0.2,45,46,48,1,3
15,1,141,2,2,3,48,87,48,0,100,1.46658619999994,,0.2,45,48,48,3,3
15,1,142,1,3,-8,82,60,83,-1,98,1.46079719999989,,0.2,90,82,83,-8,-7
15,1,143,5,3,-3,87,178,84,3,94,3.40617829999997,,0.2,90,87,84,-3,-6
15,1,144,8,3,-6,84,130,80,4,92,2.13953320000019,,0.2,90,84,80,-6,-10
15,1,145,8,1,-5,175,113,172,3,94,2.15769730000011,,0.2,0,-5,-8,-5,-8
15,1,146,6,2,-6,39,147,29,10,80,1.79987860000006,,0.2,45,39,29,-6,-16
15,1,147,3,3,2,92,168,91,1,98,3.4424125999999,,0.2,90,92,91,2,1
15,1,148,1,1,8,8,4,4,4,92,1.75167340000007,,0.2,0,8,4,8,4
15,1,149,10,3,-9,81,127,79,2,96,1.60596420000002,,0.2,90,81,79,-9,-11
15,1,150,2,3,-6,84,46,78,6,88,1.27878199999986,,0.2,90,84,78,-6,-12
15,1,151,7,1,10,10,49,3,7,86,3.46040849999986,,0.2,0,10,3,10,3
15,1,152,6,4,6,141,128,145,-4,92,2.73934030000009,,0.2,135,141,145,6,10
15,1,153,6,1,-9,171,36,164,7,86,2.03631919999998,,0.2,0,-9,-16,-9,-16
15,1,154,3,4,-6,129,55,124,5,90,3.93314069999997,,0.2,135,129,124,-6,-11
15,1,155,7,3,-1,89,93,88,1,98,2.37579039999991,,0.2,90,89,88,-1,-2
15,1,156,1,3,0,90,18,91,-1,98,2.75736500000016,,0.2,90,90,91,0,1
15,1,158,5,4,1,136,149,127,9,82,2.3877652000001,,0.2,135,136,127,1,-8
15,1,159,2,2,-6,39,20,46,-7,86,1.18179650000002,,0.2,45,39,46,-6,1
15,1,160,3,4,-8,127,162,116,11,78,1.59990470000002,,0.2,135,127,116,-8,-19
